30 100
CGGCTAAGCTGTACCCTCTCCCCCTTGACC|TGGATACGAGCAGCGCACACCCCAACGGTC
AGTCTTCAACGTAGCATAGCACATGCAAGT|GGGCAACTGGGGAGTGATTTAGGCTTGATC
TTCGAGTACGTGCGCATGTATCCAGGTCCC|CGTATGTTACGTAGGATTGTCTTAGTTTCG
CTCAGAGTTATCCTGGCTCGCGTATGTTAC|CGTGGAGAAGGCCTGCCTCTAAAACTTAAC
GATTTAGGCTTGATCATTCGAGTACGTGCA|TTAGGCTTGATCATTCGAGTACGTGCGATC
GTCTACTCAAACGCCGTTAAGGCATCTAGG|GACGTGAGCCCGGAGAGGGTAGGTACATTA
CGACCGAAGTTTTACTGGCCATGATAAAGT|CGGCTAAGCTGTACCCTCTCCCCCTTGACC
GTATGTTACGTAGGATTGTCTTAGTTTCGA|AAACTTAACCTATGTAGGTCTGATTTAGGC
CGAGTACGTGCAGTCAGTTCGCCTTGGCGT|GAGTACGTGCAGCCGAGCCTACGCGGCGAG
AACGCTTGCTTTCCAAACCGTCGCAGTCTT|TTTCAACGCTGTTGCGATGAACCTGGGCAA
ATTCGAGTACGTGCGTGCAAGAAACGCTTG|CTCTCCCCAGACGATACTCTGATTTCAACG
ACGCTATGGGTTCCTGATTTAGGCTTTGAT|TCCTCCGGGTATGCGAAGATGCGCCCTATA
ATGTTACGTAGGATTGTCTTAGTTTCGATG|ACTTAACCTATGTAGGTCTGATTTAGGCTT
CGCGTGGTCTAGCGGGTGCCCAACTCTGAT|TCGAGTACTGATTTAGGCTTGATCATTCGA
CCGTTAAGGCATCTAGGCTTTGTTATTTCG|AGAGGGTAGGTACATTAATTACATCGAGAT
AAGACCTACCGGCTAAGCTGTACCCTCTCC|CTTGTGCTCTGGATACGAGCAGCGCACACC
CATTCGAGTACGTGCTTGATCATTCGAGTA|TAAGACACTTTCTGAAGGACACACCTCTGT
CGGGCCCGCGATTTGATTTAGGCTTGATCA|GCTTGATCATTCGAGTACGTGCGCATGTAT
GTACGCTATGGGTTCCTGATTTAGGCTTTG|CGTCCTCCGGGTATGCGAAGATGCGCCCTA
TTCGAGTACGTGCCCGAGGTTGATTTAGGC|TGCAACGTAATTCCTAGTCAGCGTAACCAG
TCCCCAGACGATACTCTGATTTCAACGCTG|CAAGAAACTCCATGTAGGGATGATTTAGGC
ATGATTTAGGCTTGATCATTCGAGTACGTG|CCAACTCTGATCCCCTTGTAGCACTAGCAC
TTGCTTTCCAAACCGTCGCAGTCTTCAACG|ACGCTGTTGCGATGAACCTGGGCAACTGGG
ACGTAGCATAGCACATGCAAGTGGTATTCT|GGGGAGTGATTTAGGCTTGATCATTCGAGT
ATCATTCGAGTACGTGCGCATGTATCCAGG|CTCGCGTATGTTACGTAGGATTGTCTTAGT
GATTTAGGCTTGATCATTCGAGTACGTGCG|GAAGCCACGAAGACACTCTCCCCAGACGAT
TGTCTACTCAAACGCCGTTAAGGCATCTAG|GGACGTGAGCCCGGAGAGGGTAGGTACATT
ACTCCATGTAGGGATGATTTAGGCTTGATC|CTGGCCATGATAAAGTTCAGTACGCTATGG
GTAGGATTGTCTTAGTTTCGATGATTTAGG|CTATGTAGGTCTGATTTAGGCTTGATCATT
GTTAAGGCATCTAGGCTTTGTTATTTCGTA|AGGGTAGGTACATTAATTACATCGAGATCT
AGTACGTGCACAATAGGTACAAAGACCTAC|AGGTACACCGAGGATTTCTAGCTTGTGCTC
CAATATGCCGACTTAGGAAGAATATAGTGT|GATTTAGGCTTGATCATTCGAGTACGTGCC
TCTCCCCAGACGATACTCTGATTTCAACGC|GTCAAGAAACTCCATGTAGGGATGATTTAG
CTTGATCATTCGAGTACGTGCGCATGTATC|CTGGCTCGCGTATGTTACGTAGGATTGTCT
GGCTTGATCATTCGAGTACGTGCCATATAG|CAGGCCTATGGATGCGCTGAGCTATGATTT
TAGGTCTGATTTAGGCTTGATCATTCGAGT|TGATTTAGGCTTGATCATTCGAGTACGTGC
TCCATGTAGGGATGATTTAGGCTTGATCAT|GGCCATGATAAAGTTCAGTACGCTATGGGT
CGCGATTTGATTTAGGCTTGATCATTCGAG|TCATTCGAGTACGTGCGCATGTATCCAGGT
TTTAGGCTTGATCATTCGAGTACGTGCCAT|TAACCAGGCCTATGGATGCGCTGAGCTATG
GAGTTCGCCGATTAATGTCTACTCAAACGC|GAATATAGTGTGCGGGGACGTGAGCCCGGA
CACGAAGACACTCTCCCCAGACGATACTCT|CGTGTATCTGAGTCAAGAAACTCCATGTAG
TTAGGCTTGATCATTCGAGTACGTGCGATC|AAACCTAACGGGTACATTAGCCGAAAACAG
CTAAGACACTTTCTGAAGGACACACCTCTG|GTACGTGCAGTCAGTTCGCCTTGGCGTGTA
CATTCGAGTACGTGCTCGAGATGATTTAGG|GGTTCCTGATTTAGGCTTTGATTTAGGCTT
TAGGCTTGATCATTCGAGTACGTGCCATAT|ACCAGGCCTATGGATGCGCTGAGCTATGAT
CATTCGAGTACGTGCCATATAGATTTCCGT|TGGATGCGCTGAGCTATGATTTAGGCTTGA
GGAGTGATTTAGGCTTGATCATTCGAGTAC|AGATGATTTAGGCTTGATCATTCGAGTACG
CGTATGTTACGTAGGATTGTCTTAGTTTCG|AAAACTTAACCTATGTAGGTCTGATTTAGG
ATTCGAGTACGTGCCCGAGGTTGATTTAGG|GTGCAACGTAATTCCTAGTCAGCGTAACCA
TAAGACACTTTCTGAAGGACACACCTCTGT|TACGTGCAGTCAGTTCGCCTTGGCGTGTAG
CAACTCTGATCCCCTTGTAGCACTAGCACA|GATCATTCGAGTACGTGCGTGCAAGAAACG
TCAGCGTAACCAGGCCTATGGATGCGCTGA|AGTGGATACTAATACGCGTGGTCTAGCGGG
GATGAACCTGGGCAACTGGGGAGTGATTTA|TCATTCGAGTACGTGCTCGAGATGATTTAG
GCTTGATCATTCGAGTACGTGCCACCGTTA|ATCCCCTTGTAGCACTAGCACAATGCGAAT
GTACGTGCCATATAGATTTCCGTGGAGAAG|GCTGAGCTATGATTTAGGCTTGATCATTCG
TAGGTACATTAATTACATCGAGATCTCAGA|TCGAGTACGTGCCATATAGATTTCCGTGGA
ACGTGCCTCTATGACCACTCCTTCGAAGTG|GCTGATTTAGGCTTGATCATTCGAGTACGT
TCATTCGAGTACGTGCCTCTATGACCACTC|CGTGATTTAGGCTGATTTAGGCTTGATCAT
TCGAGTACGTGCTTGATCATTCGAGTACTG|GACACTTTCTGAAGGACACACCTCTGTGGG
AGGCTTGATCATTCGAGTACGTGCCATTAA|TGCGCATGTATCCAGGTCCCTCCAATATGC
CTCCAATATGCCGACTTAGGAAGAATATAG|GATGATTTAGGCTTGATCATTCGAGTACGT
CGATACTCTGATTTCAACGCTGTTGCGATG|TCCATGTAGGGATGATTTAGGCTTGATCAT
CGCGTAGAGTTCGCCGATTAATGTCTACTC|TAGGAAGAATATAGTGTGCGGGGACGTGAG
CGAGTACGTGCTCGAGATGATTTAGGCTTG|CCTGATTTAGGCTTTGATTTAGGCTTGATC
CCTGCCTCTAAAACTTAACCTATGTAGGTC|GTACGTGCCACCGTTAAAGATAAGTGATTT
TGCTCGAGATGATTTAGGCTTGATCATTCG|AGGCTTTGATTTAGGCTTGATCATTCGAGT
TGATCATTCGAGTACGTGCTTGATCATTCG|ATTCTAAGACACTTTCTGAAGGACACACCT
TAACCAGGCCTATGGATGCGCTGAGCTATG|TACTAATACGCGTGGTCTAGCGGGTGCCCA
GTCTAGCGGGTGCCCAACTCTGATCCCCTT|ACTGATTTAGGCTTGATCATTCGAGTACGT
TACGTGCGCATGTATCCAGGTCCCTCCAAT|TTACGTAGGATTGTCTTAGTTTCGATGATT
CGAGTACGTGCCCGAGGTTGATTTAGGCTT|CAACGTAATTCCTAGTCAGCGTAACCAGGC
ATCATTCGAGTACGTGCTTGATCATTCGAG|TCTAAGACACTTTCTGAAGGACACACCTCT
TCATTCGAGTACGTGCACAATAGGTACAAA|AGCGTACAGGTACACCGAGGATTTCTAGCT
TGGTATTCTAAGACACTTTCTGAAGGACAC|CATTCGAGTACGTGCAGTCAGTTCGCCTTG
CATGATAAAGTTCAGTACGCTATGGGTTCC|CCCCCTTGACCTTCCGTCCTCCGGGTATGC
TACATTAATTACATCGAGATCTCAGAGTTA|GTACGTGCCATATAGATTTCCGTGGAGAAG
AGAAACTCCATGTAGGGATGATTTAGGCTT|TTTACTGGCCATGATAAAGTTCAGTACGCT
GTACGTGCGTGCAAGAAACGCTTGCTTTCC|CCAGACGATACTCTGATTTCAACGCTGTTG
TTCCTTCGACCGAAGTTTTACTGGCCATGA|ACCTACCGGCTAAGCTGTACCCTCTCCCCC
TTTAGGCTGATTTAGGCTTGATCATTCGAG|ATAGCACATGCAAGTGGTATTCTAAGACAC
TTGGCGTGTAGTCCTCTACGTGTATCTGAG|CGGCGAGAACATGCAGGTTCCTTCGACCGA
CGATGATTTAGGCTTGATCATTCGAGTACG|GGCTTGATCATTCGAGTACGTGCAACGTAA
GCGTAACCAGGCCTATGGATGCGCTGAGCT|GGATACTAATACGCGTGGTCTAGCGGGTGC
AGGCTTTGATTTAGGCTTGATCATTCGAGT|GCGCCCTATAAAACCTAACGGGTACATTAG
CATGTAGGGATGATTTAGGCTTGATCATTC|CCATGATAAAGTTCAGTACGCTATGGGTTC
ATGTAGGTCTGATTTAGGCTTGATCATTCG|AAGTGATTTAGGCTTGATCATTCGAGTACG
TCATTCGAGTACGTGCTTGATCATTCGAGT|CTAAGACACTTTCTGAAGGACACACCTCTG
TCGAGTACTGATTTAGGCTTGATCATTCGA|CCTCTGTGGGAAGCCACGAAGACACTCTCC
GCTTGATCATTCGAGTACGTGCAGTCAGTT|CTTGATCATTCGAGTACGTGCAGCCGAGCC
GTACTGATTTAGGCTTGATCATTCGAGTAC|TGTGGGAAGCCACGAAGACACTCTCCCCAG
GAGTTATCCTGGCTCGCGTATGTTACGTAG|GAGAAGGCCTGCCTCTAAAACTTAACCTAT
CTGTGGGAAGCCACGAAGACACTCTCCCCA|GTAGTCCTCTACGTGTATCTGAGTCAAGAA
CAAACCGTCGCAGTCTTCAACGTAGCATAG|GCGATGAACCTGGGCAACTGGGGAGTGATT
ATGAACCTGGGCAACTGGGGAGTGATTTAG|CATTCGAGTACGTGCTCGAGATGATTTAGG
ACTGGGGAGTGATTTAGGCTTGATCATTCG|GCTCGAGATGATTTAGGCTTGATCATTCGA
TCGAGTACGTGCCATTAACTATCCGCGTAG|CAGGTCCCTCCAATATGCCGACTTAGGAAG
CCACTCCTTCGAAGTGGATACTAATACGCG|GATCATTCGAGTACGTGCTTGATCATTCGA
ACGTGCCATTAACTATCCGCGTAGAGTTCG|CCTCCAATATGCCGACTTAGGAAGAATATA
TTTCCGTGGAGAAGGCCTGCCTCTAAAACT|GGCTTGATCATTCGAGTACGTGCCACCGTT
TGCGATCATTCGAGTACGTGCACAATAGGT|AAAACAGCGTACAGGTACACCGAGGATTTC
GTCCTCTACGTGTATCTGAGTCAAGAAACT|ATGCAGGTTCCTTCGACCGAAGTTTTACTG
ATGATTTAGGCTTGATCATTCGAGTACGTG|CTTGATCATTCGAGTACGTGCAACGTAATT
GATCATTCGAGTACGTGCGATCATTCGAGT|CGGGTACATTAGCCGAAAACAGCGTACAGG
AGTCAGCGTAACCAGGCCTATGGATGCGCT|GAAGTGGATACTAATACGCGTGGTCTAGCG
CGTGCAGTCAGTTCGCCTTGGCGTGTAGTC|GTGCAGCCGAGCCTACGCGGCGAGAACATG
CGCCGTTAAGGCATCTAGGCTTTGTTATTT|GGAGAGGGTAGGTACATTAATTACATCGAG
TCGAGATGATTTAGGCTTGATCATTCGAGT|CTTTGATTTAGGCTTGATCATTCGAGTACG
GCCGACTTAGGAAGAATATAGTGTGCGGGG|GGCTTGATCATTCGAGTACGTGCCCGAGGT
CAGAGTTATCCTGGCTCGCGTATGTTACGT|TGGAGAAGGCCTGCCTCTAAAACTTAACCT
GACCACTCCTTCGAAGTGGATACTAATACG|TTGATCATTCGAGTACGTGCTTGATCATTC
CCTTCGAAGTGGATACTAATACGCGTGGTC|TTCGAGTACGTGCTTGATCATTCGAGTACT
AGCACAATGCGAATCTGAAAATCTAGGGTT|GAAACGCTTGCTTTCCAAACCGTCGCAGTC
AGGCTTGATCATTCGAGTACGTGCGATCAT|ACCTAACGGGTACATTAGCCGAAAACAGCG
GCTCGAGATGATTTAGGCTTGATCATTCGA|GGCTTTGATTTAGGCTTGATCATTCGAGTA
TAGGCTTGATCATTCGAGTACGTGCCACCG|CTGATCCCCTTGTAGCACTAGCACAATGCG
TGCCTCTATGACCACTCCTTCGAAGTGGAT|GATTTAGGCTTGATCATTCGAGTACGTGCT
CATATAGATTTCCGTGGAGAAGGCCTGCCT|ATGATTTAGGCTTGATCATTCGAGTACGTG
TCCCGCCCGTGATTTAGGCTGATTTAGGCT|CTTCAACGTAGCATAGCACATGCAAGTGGT
TACGTGCAGCCGAGCCTACGCGGCGAGAAC|GTGCGATCATTCGAGTACGTGCACAATAGG
CCGAAGTTTTACTGGCCATGATAAAGTTCA|CTAAGCTGTACCCTCTCCCCCTTGACCTTC
ACACCTCTGTGGGAAGCCACGAAGACACTC|TGGCGTGTAGTCCTCTACGTGTATCTGAGT
CCTTGGCGTGTAGTCCTCTACGTGTATCTG|CGCGGCGAGAACATGCAGGTTCCTTCGACC
TATCTGAGTCAAGAAACTCCATGTAGGGAT|TCGACCGAAGTTTTACTGGCCATGATAAAG
GAAGGACACACCTCTGTGGGAAGCCACGAA|TTCGCCTTGGCGTGTAGTCCTCTACGTGTA
CGTGCTCGAGATGATTTAGGCTTGATCATT|TTAGGCTTTGATTTAGGCTTGATCATTCGA
CGCTATGGGTTCCTGATTTAGGCTTTGATT|CCTCCGGGTATGCGAAGATGCGCCCTATAA
GTCTTCAACGTAGCATAGCACATGCAAGTG|GGCAACTGGGGAGTGATTTAGGCTTGATCA
CGAAGTGGATACTAATACGCGTGGTCTAGC|AGTACGTGCTTGATCATTCGAGTACTGATT
GGAAGCCACGAAGACACTCTCCCCAGACGA|CCTCTACGTGTATCTGAGTCAAGAAACTCC
AATACGCGTGGTCTAGCGGGTGCCCAACTC|TCATTCGAGTACTGATTTAGGCTTGATCAT
CGAGTACGTGCTTGATCATTCGAGTACTGA|ACACTTTCTGAAGGACACACCTCTGTGGGA
TCGAGTACGTGCTCGAGATGATTTAGGCTT|TCCTGATTTAGGCTTTGATTTAGGCTTGAT
GGTTCCTGATTTAGGCTTTGATTTAGGCTT|GTATGCGAAGATGCGCCCTATAAAACCTAA
GCTCGCGTATGTTACGTAGGATTGTCTTAG|CCTCTAAAACTTAACCTATGTAGGTCTGAT
AGGCTTGATCATTCGAGTACGTGCAGTCAG|GGCTTGATCATTCGAGTACGTGCAGCCGAG
TTCCCGCCCGTGATTTAGGCTGATTTAGGC|TCTTCAACGTAGCATAGCACATGCAAGTGG
TGCAAGTGGTATTCTAAGACACTTTCTGAA|CTTGATCATTCGAGTACGTGCAGTCAGTTC
TCGTAGTGATTTAGGCTTGATCATTCGAGT|GATCTCAGAGTTATCCTGGCTCGCGTATGT
GCCACGAAGACACTCTCCCCAGACGATACT|TACGTGTATCTGAGTCAAGAAACTCCATGT
AGTGATTTAGGCTTGATCATTCGAGTACGT|ATCTAGGGTTCCCGCCCGTGATTTAGGCTG
GACGGGCCCGCGATTTGATTTAGGCTTGAT|AGGCTTGATCATTCGAGTACGTGCGCATGT
GTTCCTGATTTAGGCTTTGATTTAGGCTTG|TATGCGAAGATGCGCCCTATAAAACCTAAC
ACGCTGTTGCGATGAACCTGGGCAACTGGG|TTAGGCTTGATCATTCGAGTACGTGCTCGA
CGAGCCTACGCGGCGAGAACATGCAGGTTC|TCGAGTACGTGCACAATAGGTACAAAGACC
CCTTCGACCGAAGTTTTACTGGCCATGATA|CTACCGGCTAAGCTGTACCCTCTCCCCCTT
GGCTTTGTTATTTCGTAGTGATTTAGGCTT|TAATTACATCGAGATCTCAGAGTTATCCTG
TTCGAGTACGTGCCATATAGATTTCCGTGG|GATGCGCTGAGCTATGATTTAGGCTTGATC
AGTGGATACTAATACGCGTGGTCTAGCGGG|ACGTGCTTGATCATTCGAGTACTGATTTAG
AGTTCGCCTTGGCGTGTAGTCCTCTACGTG|AGCCTACGCGGCGAGAACATGCAGGTTCCT
TGGGGAGTGATTTAGGCTTGATCATTCGAG|TCGAGATGATTTAGGCTTGATCATTCGAGT
ATTTAGGCTTGATCATTCGAGTACGTGCAG|TTTAGGCTTGATCATTCGAGTACGTGCAGC
CTTTGATTTAGGCTTGATCATTCGAGTACG|CCCTATAAAACCTAACGGGTACATTAGCCG
TGCAGGTTCCTTCGACCGAAGTTTTACTGG|ACAAAGACCTACCGGCTAAGCTGTACCCTC
TCCGTGGAGAAGGCCTGCCTCTAAAACTTA|CTTGATCATTCGAGTACGTGCCACCGTTAA
TCTGATTTCAACGCTGTTGCGATGAACCTG|TAGGGATGATTTAGGCTTGATCATTCGAGT
GTACGTGCAGTCAGTTCGCCTTGGCGTGTA|TACGTGCAGCCGAGCCTACGCGGCGAGAAC
TGCACAATAGGTACAAAGACCTACCGGCTA|ACCGAGGATTTCTAGCTTGTGCTCTGGATA
GCATAGCACATGCAAGTGGTATTCTAAGAC|GTGATTTAGGCTTGATCATTCGAGTACGTG
CGAGTACGTGCCATTAACTATCCGCGTAGA|AGGTCCCTCCAATATGCCGACTTAGGAAGA
TAGGGATGATTTAGGCTTGATCATTCGAGT|GATAAAGTTCAGTACGCTATGGGTTCCTGA
CCCAGACGATACTCTGATTTCAACGCTGTT|AGAAACTCCATGTAGGGATGATTTAGGCTT
TGAGCTATGATTTAGGCTTGATCATTCGAG|GGGTGCCCAACTCTGATCCCCTTGTAGCAC
TCTTCAACGTAGCATAGCACATGCAAGTGG|GCAACTGGGGAGTGATTTAGGCTTGATCAT
TGGTCTAGCGGGTGCCCAACTCTGATCCCC|GTACTGATTTAGGCTTGATCATTCGAGTAC
TTCGAGTACGTGCCATTAACTATCCGCGTA|CCAGGTCCCTCCAATATGCCGACTTAGGAA
GTGCGCATGTATCCAGGTCCCTCCAATATG|CGTAGGATTGTCTTAGTTTCGATGATTTAG
GATCATTCGAGTACGTGCACAATAGGTACA|ACAGCGTACAGGTACACCGAGGATTTCTAG
CGATGAACCTGGGCAACTGGGGAGTGATTT|ATCATTCGAGTACGTGCTCGAGATGATTTA
TGATTTAGGCTTGATCATTCGAGTACGTGC|AGGCTTGATCATTCGAGTACGTGCCTCTAT
AGTACGTGCCACCGTTAAAGATAAGTGATT|ACTAGCACAATGCGAATCTGAAAATCTAGG
TACGTGCGATCATTCGAGTACGTGCACAAT|GCCGAAAACAGCGTACAGGTACACCGAGGA
CACTAGCACAATGCGAATCTGAAAATCTAG|GCAAGAAACGCTTGCTTTCCAAACCGTCGC
GAACCTGGGCAACTGGGGAGTGATTTAGGC|TTCGAGTACGTGCTCGAGATGATTTAGGCT
TGGAGAAGGCCTGCCTCTAAAACTTAACCT|ATCATTCGAGTACGTGCCACCGTTAAAGAT
GTGATTTAGGCTTGATCATTCGAGTACGTG|CAGAGTTATCCTGGCTCGCGTATGTTACGT
CAATAGGTACAAAGACCTACCGGCTAAGCT|AGGATTTCTAGCTTGTGCTCTGGATACGAG
GTCTTAGTTTCGATGATTTAGGCTTGATCA|GTCTGATTTAGGCTTGATCATTCGAGTACG
CGGAGAGGGTAGGTACATTAATTACATCGA|CTTGATCATTCGAGTACGTGCCATATAGAT
AGCCCGGAGAGGGTAGGTACATTAATTACA|TAGGCTTGATCATTCGAGTACGTGCCATAT
AATCTAGGGTTCCCGCCCGTGATTTAGGCT|CCGTCGCAGTCTTCAACGTAGCATAGCACA
TAGTTTCGATGATTTAGGCTTGATCATTCG|GATTTAGGCTTGATCATTCGAGTACGTGCA
CGAGTACGTGCCATATAGATTTCCGTGGAG|TGCGCTGAGCTATGATTTAGGCTTGATCAT
CAGGTTCCTTCGACCGAAGTTTTACTGGCC|AAAGACCTACCGGCTAAGCTGTACCCTCTC
TAGCACTAGCACAATGCGAATCTGAAAATC|CGTGCAAGAAACGCTTGCTTTCCAAACCGT
CTAAGCTGTACCCTCTCCCCCTTGACCTTC|ATACGAGCAGCGCACACCCCAACGGTCCCG
GGGGACGTGAGCCCGGAGAGGGTAGGTACA|AGGTTGATTTAGGCTTGATCATTCGAGTAC
TCATTCGAGTACGTGCGCATGTATCCAGGT|TCGCGTATGTTACGTAGGATTGTCTTAGTT
CGTAGAGTTCGCCGATTAATGTCTACTCAA|GGAAGAATATAGTGTGCGGGGACGTGAGCC
CCTCTGTGGGAAGCCACGAAGACACTCTCC|CGTGTAGTCCTCTACGTGTATCTGAGTCAA
AACTTAACCTATGTAGGTCTGATTTAGGCT|CGTTAAAGATAAGTGATTTAGGCTTGATCA
CCTAGTCAGCGTAACCAGGCCTATGGATGC|TTCGAAGTGGATACTAATACGCGTGGTCTA
ACGTGCGTGCAAGAAACGCTTGCTTTCCAA|AGACGATACTCTGATTTCAACGCTGTTGCG
CATTCGAGTACGTGCCACCGTTAAAGATAA|TGTAGCACTAGCACAATGCGAATCTGAAAA
GTACATTAATTACATCGAGATCTCAGAGTT|AGTACGTGCCATATAGATTTCCGTGGAGAA
CTTCAACGTAGCATAGCACATGCAAGTGGT|CAACTGGGGAGTGATTTAGGCTTGATCATT
CTGGCTCGCGTATGTTACGTAGGATTGTCT|CTGCCTCTAAAACTTAACCTATGTAGGTCT
TTAGGCTTGATCATTCGAGTACGTGCGTGC|GCCACGAAGACACTCTCCCCAGACGATACT
GTGCAAGAAACGCTTGCTTTCCAAACCGTC|TACTCTGATTTCAACGCTGTTGCGATGAAC
GGAAGAATATAGTGTGCGGGGACGTGAGCC|ATTCGAGTACGTGCCCGAGGTTGATTTAGG
TCATTCGAGTACGTGCAGTCAGTTCGCCTT|CATTCGAGTACGTGCAGCCGAGCCTACGCG
TTCGAGTACGTGCAGTCAGTTCGCCTTGGC|TCGAGTACGTGCAGCCGAGCCTACGCGGCG
GTGCAGCCGAGCCTACGCGGCGAGAACATG|CGATCATTCGAGTACGTGCACAATAGGTAC
CACCGTTAAAGATAAGTGATTTAGGCTTGA|ATGCGAATCTGAAAATCTAGGGTTCCCGCC
GCTTGATCATTCGAGTACGTGCTTGATCAT|GGTATTCTAAGACACTTTCTGAAGGACACA
TACGTGCAACGTAATTCCTAGTCAGCGTAA|CCTCTATGACCACTCCTTCGAAGTGGATAC
TCTAGGCTTTGTTATTTCGTAGTGATTTAG|ACATTAATTACATCGAGATCTCAGAGTTAT
ATCATTCGAGTACGTGCAACGTAATTCCTA|CGAGTACGTGCCTCTATGACCACTCCTTCG
CGTGCCCGAGGTTGATTTAGGCTTGATCAT|AATTCCTAGTCAGCGTAACCAGGCCTATGG
ATGTATCCAGGTCCCTCCAATATGCCGACT|ATTGTCTTAGTTTCGATGATTTAGGCTTGA
TTTTACTGGCCATGATAAAGTTCAGTACGC|TGTACCCTCTCCCCCTTGACCTTCCGTCCT
GCCTCTAAAACTTAACCTATGTAGGTCTGA|CGTGCCACCGTTAAAGATAAGTGATTTAGG
AATGCGAATCTGAAAATCTAGGGTTCCCGC|GCTTGCTTTCCAAACCGTCGCAGTCTTCAA
TACTCTGATTTCAACGCTGTTGCGATGAAC|ATGTAGGGATGATTTAGGCTTGATCATTCG
ATTTAGGCTTGATCATTCGAGTACGTGCTC|TCAGTACGCTATGGGTTCCTGATTTAGGCT
CATTCGAGTACGTGCGATCATTCGAGTACG|GTACATTAGCCGAAAACAGCGTACAGGTAC
CTAGTCAGCGTAACCAGGCCTATGGATGCG|TCGAAGTGGATACTAATACGCGTGGTCTAG
TAGATTTCCGTGGAGAAGGCCTGCCTCTAA|TTTAGGCTTGATCATTCGAGTACGTGCCAC
GCGTGTAGTCCTCTACGTGTATCTGAGTCA|CGAGAACATGCAGGTTCCTTCGACCGAAGT
ATACTAATACGCGTGGTCTAGCGGGTGCCC|CTTGATCATTCGAGTACTGATTTAGGCTTG
CCTCCAATATGCCGACTTAGGAAGAATATA|CGATGATTTAGGCTTGATCATTCGAGTACG
AAAACTTAACCTATGTAGGTCTGATTTAGG|ACCGTTAAAGATAAGTGATTTAGGCTTGAT
CTATGATTTAGGCTTGATCATTCGAGTACG|GCCCAACTCTGATCCCCTTGTAGCACTAGC
ATTTAGGCTTGATCATTCGAGTACGTGCCA|TACGTGCGCATGTATCCAGGTCCCTCCAAT
CATTAATTACATCGAGATCTCAGAGTTATC|ACGTGCCATATAGATTTCCGTGGAGAAGGC
GCGTAGAGTTCGCCGATTAATGTCTACTCA|AGGAAGAATATAGTGTGCGGGGACGTGAGC
CTGATTTAGGCTTGATCATTCGAGTACGTG|TAGGCTTGATCATTCGAGTACGTGCCTCTA
GGACACACCTCTGTGGGAAGCCACGAAGAC|GCCTTGGCGTGTAGTCCTCTACGTGTATCT
CTTGATCATTCGAGTACGTGCAGTCAGTTC|TTGATCATTCGAGTACGTGCAGCCGAGCCT
TGTGCGGGGACGTGAGCCCGGAGAGGGTAG|GCCCGAGGTTGATTTAGGCTTGATCATTCG
GTGTGCGGGGACGTGAGCCCGGAGAGGGTA|TGCCCGAGGTTGATTTAGGCTTGATCATTC
ACCTATGTAGGTCTGATTTAGGCTTGATCA|AGATAAGTGATTTAGGCTTGATCATTCGAG
AGTACGTGCGTGCAAGAAACGCTTGCTTTC|CCCAGACGATACTCTGATTTCAACGCTGTT
AGTACGCTATGGGTTCCTGATTTAGGCTTT|CCGTCCTCCGGGTATGCGAAGATGCGCCCT
TCTAAAACTTAACCTATGTAGGTCTGATTT|GCCACCGTTAAAGATAAGTGATTTAGGCTT
CCGTGGAGAAGGCCTGCCTCTAAAACTTAA|TTGATCATTCGAGTACGTGCCACCGTTAAA
AGTACGTGCCCGAGGTTGATTTAGGCTTGA|ACGTAATTCCTAGTCAGCGTAACCAGGCCT
TGATTTAGGCTTGATCATTCGAGTACGTGC|GATTTAGGCTTGATCATTCGAGTACGTGCA
TAATGTCTACTCAAACGCCGTTAAGGCATC|CGGGGACGTGAGCCCGGAGAGGGTAGGTAC
GCCGTTAAGGCATCTAGGCTTTGTTATTTC|GAGAGGGTAGGTACATTAATTACATCGAGA
GTGCCATTAACTATCCGCGTAGAGTTCGCC|TCCAATATGCCGACTTAGGAAGAATATAGT
CCCTTGTAGCACTAGCACAATGCGAATCTG|TACGTGCGTGCAAGAAACGCTTGCTTTCCA
CTGGGGAGTGATTTAGGCTTGATCATTCGA|CTCGAGATGATTTAGGCTTGATCATTCGAG
GTACGTGCCACCGTTAAAGATAAGTGATTT|CTAGCACAATGCGAATCTGAAAATCTAGGG
GAGTACGTGCAGTCAGTTCGCCTTGGCGTG|AGTACGTGCAGCCGAGCCTACGCGGCGAGA
TTGTCTTAGTTTCGATGATTTAGGCTTGAT|AGGTCTGATTTAGGCTTGATCATTCGAGTA
CGTAGTGATTTAGGCTTGATCATTCGAGTA|ATCTCAGAGTTATCCTGGCTCGCGTATGTT
TTGATTTAGGCTTGATCATTCGAGTACGTG|GAGTACGTGCGCATGTATCCAGGTCCCTCC
TTCTGAAGGACACACCTCTGTGGGAAGCCA|TCAGTTCGCCTTGGCGTGTAGTCCTCTACG
CCCGCGATTTGATTTAGGCTTGATCATTCG|GATCATTCGAGTACGTGCGCATGTATCCAG
TTCCGTGGAGAAGGCCTGCCTCTAAAACTT|GCTTGATCATTCGAGTACGTGCCACCGTTA
AAGACACTCTCCCCAGACGATACTCTGATT|TATCTGAGTCAAGAAACTCCATGTAGGGAT
CTAAAACTTAACCTATGTAGGTCTGATTTA|CCACCGTTAAAGATAAGTGATTTAGGCTTG
CGTGCGTGCAAGAAACGCTTGCTTTCCAAA|GACGATACTCTGATTTCAACGCTGTTGCGA
TACGTGCTCGAGATGATTTAGGCTTGATCA|ATTTAGGCTTTGATTTAGGCTTGATCATTC
TAACCTATGTAGGTCTGATTTAGGCTTGAT|AAAGATAAGTGATTTAGGCTTGATCATTCG
TGTATCTGAGTCAAGAAACTCCATGTAGGG|CTTCGACCGAAGTTTTACTGGCCATGATAA
TACGCGTGGTCTAGCGGGTGCCCAACTCTG|ATTCGAGTACTGATTTAGGCTTGATCATTC
AGCACTAGCACAATGCGAATCTGAAAATCT|GTGCAAGAAACGCTTGCTTTCCAAACCGTC
TTGATTTAGGCTTGATCATTCGAGTACGTG|AGCGTAACCAGGCCTATGGATGCGCTGAGC
ATGGGTTCCTGATTTAGGCTTTGATTTAGG|CGGGTATGCGAAGATGCGCCCTATAAAACC
GAGAACATGCAGGTTCCTTCGACCGAAGTT|AATAGGTACAAAGACCTACCGGCTAAGCTG
GCGATGAACCTGGGCAACTGGGGAGTGATT|GATCATTCGAGTACGTGCTCGAGATGATTT
TAAAGATAAGTGATTTAGGCTTGATCATTC|ATCTGAAAATCTAGGGTTCCCGCCCGTGAT
CCGGAGAGGGTAGGTACATTAATTACATCG|GCTTGATCATTCGAGTACGTGCCATATAGA
TGCGCTGAGCTATGATTTAGGCTTGATCAT|CTAGCGGGTGCCCAACTCTGATCCCCTTGT
TTCGAGTACTGATTTAGGCTTGATCATTCG|ACCTCTGTGGGAAGCCACGAAGACACTCTC
GATTTCCGTGGAGAAGGCCTGCCTCTAAAA|TAGGCTTGATCATTCGAGTACGTGCCACCG
CCAGACGATACTCTGATTTCAACGCTGTTG|GAAACTCCATGTAGGGATGATTTAGGCTTG
CGGCGAGAACATGCAGGTTCCTTCGACCGA|GCACAATAGGTACAAAGACCTACCGGCTAA
TATCCGCGTAGAGTTCGCCGATTAATGTCT|GACTTAGGAAGAATATAGTGTGCGGGGACG
ATGTCTACTCAAACGCCGTTAAGGCATCTA|GGGACGTGAGCCCGGAGAGGGTAGGTACAT
CAAGAAACGCTTGCTTTCCAAACCGTCGCA|TCTGATTTCAACGCTGTTGCGATGAACCTG
CTTAACCTATGTAGGTCTGATTTAGGCTTG|TTAAAGATAAGTGATTTAGGCTTGATCATT
GCAGCCGAGCCTACGCGGCGAGAACATGCA|ATCATTCGAGTACGTGCACAATAGGTACAA
CTGCCTCTAAAACTTAACCTATGTAGGTCT|TACGTGCCACCGTTAAAGATAAGTGATTTA
CGCATGTATCCAGGTCCCTCCAATATGCCG|AGGATTGTCTTAGTTTCGATGATTTAGGCT
GGTTCCTTCGACCGAAGTTTTACTGGCCAT|AGACCTACCGGCTAAGCTGTACCCTCTCCC
ATTTAGGCTTGATCATTCGAGTACGTGCGT|AAGCCACGAAGACACTCTCCCCAGACGATA
GCACAATGCGAATCTGAAAATCTAGGGTTC|AAACGCTTGCTTTCCAAACCGTCGCAGTCT
GTACGTGCTTGATCATTCGAGTACTGATTT|CTTTCTGAAGGACACACCTCTGTGGGAAGC
GTGCGTGCAAGAAACGCTTGCTTTCCAAAC|ACGATACTCTGATTTCAACGCTGTTGCGAT
CATTCGAGTACTGATTTAGGCTTGATCATT|ACACCTCTGTGGGAAGCCACGAAGACACTC
GTTACGTAGGATTGTCTTAGTTTCGATGAT|TTAACCTATGTAGGTCTGATTTAGGCTTGA
TTGTAGCACTAGCACAATGCGAATCTGAAA|GTGCGTGCAAGAAACGCTTGCTTTCCAAAC
GTGGTATTCTAAGACACTTTCTGAAGGACA|TCATTCGAGTACGTGCAGTCAGTTCGCCTT
GATTTCAACGCTGTTGCGATGAACCTGGGC|GGATGATTTAGGCTTGATCATTCGAGTACG
GGTATTCTAAGACACTTTCTGAAGGACACA|ATTCGAGTACGTGCAGTCAGTTCGCCTTGG
TCGAGTACGTGCAGCCGAGCCTACGCGGCG|AGTACGTGCGATCATTCGAGTACGTGCACA
ATTCGAGTACGTGCAACGTAATTCCTAGTC|GTACGTGCCTCTATGACCACTCCTTCGAAG
TTACGTAGGATTGTCTTAGTTTCGATGATT|TAACCTATGTAGGTCTGATTTAGGCTTGAT
TTGATCATTCGAGTACGTGCCATATAGATT|GCCTATGGATGCGCTGAGCTATGATTTAGG
CTATGACCACTCCTTCGAAGTGGATACTAA|AGGCTTGATCATTCGAGTACGTGCTTGATC
GGCTTGATCATTCGAGTACGTGCCACCGTT|GATCCCCTTGTAGCACTAGCACAATGCGAA
TGATCATTCGAGTACGTGCAGTCAGTTCGC|GATCATTCGAGTACGTGCAGCCGAGCCTAC
ACGCCGTTAAGGCATCTAGGCTTTGTTATT|CGGAGAGGGTAGGTACATTAATTACATCGA
ATCATTCGAGTACGTGCAGTCAGTTCGCCT|TCATTCGAGTACGTGCAGCCGAGCCTACGC
TATGTAGGTCTGATTTAGGCTTGATCATTC|TAAGTGATTTAGGCTTGATCATTCGAGTAC
TCATTCGAGTACGTGCGATCATTCGAGTAC|GGTACATTAGCCGAAAACAGCGTACAGGTA
CTATGGGTTCCTGATTTAGGCTTTGATTTA|TCCGGGTATGCGAAGATGCGCCCTATAAAA
AGATGATTTAGGCTTGATCATTCGAGTACG|TGATTTAGGCTTGATCATTCGAGTACGTGC
GTACGTGCGCATGTATCCAGGTCCCTCCAA|GTTACGTAGGATTGTCTTAGTTTCGATGAT
CGTGCGATCATTCGAGTACGTGCACAATAG|CGAAAACAGCGTACAGGTACACCGAGGATT
GAAGCCACGAAGACACTCTCCCCAGACGAT|CTCTACGTGTATCTGAGTCAAGAAACTCCA
TTGCGATGAACCTGGGCAACTGGGGAGTGA|TTGATCATTCGAGTACGTGCTCGAGATGAT
CCCGTGATTTAGGCTGATTTAGGCTTGATC|ACGTAGCATAGCACATGCAAGTGGTATTCT
CGTGCCACCGTTAAAGATAAGTGATTTAGG|GCACAATGCGAATCTGAAAATCTAGGGTTC
ACGTGAGCCCGGAGAGGGTAGGTACATTAA|TGATTTAGGCTTGATCATTCGAGTACGTGC
ACATGCAGGTTCCTTCGACCGAAGTTTTAC|GGTACAAAGACCTACCGGCTAAGCTGTACC
CATTCGAGTACGTGCCCGAGGTTGATTTAG|CGTGCAACGTAATTCCTAGTCAGCGTAACC
ATCTCAGAGTTATCCTGGCTCGCGTATGTT|TCCGTGGAGAAGGCCTGCCTCTAAAACTTA
CGCCTTGGCGTGTAGTCCTCTACGTGTATC|TACGCGGCGAGAACATGCAGGTTCCTTCGA
AGAATATAGTGTGCGGGGACGTGAGCCCGG|CGAGTACGTGCCCGAGGTTGATTTAGGCTT
GGACGTGAGCCCGGAGAGGGTAGGTACATT|GTTGATTTAGGCTTGATCATTCGAGTACGT
GGATGATTTAGGCTTGATCATTCGAGTACG|AAAGTTCAGTACGCTATGGGTTCCTGATTT
GATTTAGGCTTGATCATTCGAGTACGTGCG|GAGTTATCCTGGCTCGCGTATGTTACGTAG
TACGTGCCCGAGGTTGATTTAGGCTTGATC|GTAATTCCTAGTCAGCGTAACCAGGCCTAT
TGGCGTGTAGTCCTCTACGTGTATCTGAGT|GGCGAGAACATGCAGGTTCCTTCGACCGAA
ATTTAGGCTTGATCATTCGAGTACGTGCCT|AGGGTTCCCGCCCGTGATTTAGGCTGATTT
GGGTTCCTGATTTAGGCTTTGATTTAGGCT|GGTATGCGAAGATGCGCCCTATAAAACCTA
GATTTAGGCTTGATCATTCGAGTACGTGCC|TGATCATTCGAGTACGTGCAACGTAATTCC
CGTGCCTCTATGACCACTCCTTCGAAGTGG|CTGATTTAGGCTTGATCATTCGAGTACGTG
CGCTTGCTTTCCAAACCGTCGCAGTCTTCA|TCAACGCTGTTGCGATGAACCTGGGCAACT
TACAAAGACCTACCGGCTAAGCTGTACCCT|CTAGCTTGTGCTCTGGATACGAGCAGCGCA
AGGCTTGATCATTCGAGTACGTGCCATATA|CCAGGCCTATGGATGCGCTGAGCTATGATT
TAGGCTTGATCATTCGAGTACGTGCGTGCA|CCACGAAGACACTCTCCCCAGACGATACTC
CCGTGATTTAGGCTGATTTAGGCTTGATCA|CGTAGCATAGCACATGCAAGTGGTATTCTA
ATACGCGTGGTCTAGCGGGTGCCCAACTCT|CATTCGAGTACTGATTTAGGCTTGATCATT
GGGTAGGTACATTAATTACATCGAGATCTC|CATTCGAGTACGTGCCATATAGATTTCCGT
TCGAGATCTCAGAGTTATCCTGGCTCGCGT|AGATTTCCGTGGAGAAGGCCTGCCTCTAAA
TAGGCTTGATCATTCGAGTACGTGCTTGAT|AGTGGTATTCTAAGACACTTTCTGAAGGAC
TTTGATTTAGGCTTGATCATTCGAGTACGT|CGAGTACGTGCGCATGTATCCAGGTCCCTC
GTATCCAGGTCCCTCCAATATGCCGACTTA|TGTCTTAGTTTCGATGATTTAGGCTTGATC
GTGCACAATAGGTACAAAGACCTACCGGCT|CACCGAGGATTTCTAGCTTGTGCTCTGGAT
TGGGTTCCTGATTTAGGCTTTGATTTAGGC|GGGTATGCGAAGATGCGCCCTATAAAACCT
AATTACATCGAGATCTCAGAGTTATCCTGG|GCCATATAGATTTCCGTGGAGAAGGCCTGC
AAAGACCTACCGGCTAAGCTGTACCCTCTC|GCTTGTGCTCTGGATACGAGCAGCGCACAC
TGATTTAGGCTTTGATTTAGGCTTGATCAT|GAAGATGCGCCCTATAAAACCTAACGGGTA
GAAACTCCATGTAGGGATGATTTAGGCTTG|TTACTGGCCATGATAAAGTTCAGTACGCTA
GGTAGGTACATTAATTACATCGAGATCTCA|ATTCGAGTACGTGCCATATAGATTTCCGTG
CTATCCGCGTAGAGTTCGCCGATTAATGTC|CGACTTAGGAAGAATATAGTGTGCGGGGAC
CTCAAACGCCGTTAAGGCATCTAGGCTTTG|GAGCCCGGAGAGGGTAGGTACATTAATTAC
ATCATTCGAGTACGTGCCATATAGATTTCC|TATGGATGCGCTGAGCTATGATTTAGGCTT
TTTAGGCTTGATCATTCGAGTACGTGCAGT|TTAGGCTTGATCATTCGAGTACGTGCAGCC
GTGGTCTAGCGGGTGCCCAACTCTGATCCC|AGTACTGATTTAGGCTTGATCATTCGAGTA
TAAAGTTCAGTACGCTATGGGTTCCTGATT|TTGACCTTCCGTCCTCCGGGTATGCGAAGA
CTGAGTCAAGAAACTCCATGTAGGGATGAT|ACCGAAGTTTTACTGGCCATGATAAAGTTC
CCCGGAGAGGGTAGGTACATTAATTACATC|GGCTTGATCATTCGAGTACGTGCCATATAG
ATGCAAGTGGTATTCTAAGACACTTTCTGA|GCTTGATCATTCGAGTACGTGCAGTCAGTT
GTCAGCGTAACCAGGCCTATGGATGCGCTG|AAGTGGATACTAATACGCGTGGTCTAGCGG
AGGCTTGATCATTCGAGTACGTGCTTGATC|GTGGTATTCTAAGACACTTTCTGAAGGACA
TGATTTAGGCTTGATCATTCGAGTACGTGC|GCGTAACCAGGCCTATGGATGCGCTGAGCT
TCGAGTACGTGCGCATGTATCCAGGTCCCT|GTATGTTACGTAGGATTGTCTTAGTTTCGA
GATTTAGGCTTGATCATTCGAGTACGTGCG|ATAAAACCTAACGGGTACATTAGCCGAAAA
CGTAGGATTGTCTTAGTTTCGATGATTTAG|CCTATGTAGGTCTGATTTAGGCTTGATCAT
CCAGGTCCCTCCAATATGCCGACTTAGGAA|TTAGTTTCGATGATTTAGGCTTGATCATTC
CTACGCGGCGAGAACATGCAGGTTCCTTCG|TACGTGCACAATAGGTACAAAGACCTACCG
ATTTAGGCTTGATCATTCGAGTACGTGCGC|AGTTATCCTGGCTCGCGTATGTTACGTAGG
GGCTTGATCATTCGAGTACGTGCGTGCAAG|ACGAAGACACTCTCCCCAGACGATACTCTG
TGATTTAGGCTTGATCATTCGAGTACGTGC|GTTCAGTACGCTATGGGTTCCTGATTTAGG
ATCATTCGAGTACGTGCCATTAACTATCCG|GTATCCAGGTCCCTCCAATATGCCGACTTA
ATAAAGTTCAGTACGCTATGGGTTCCTGAT|CTTGACCTTCCGTCCTCCGGGTATGCGAAG
TTTCTGAAGGACACACCTCTGTGGGAAGCC|GTCAGTTCGCCTTGGCGTGTAGTCCTCTAC
TGGCTCGCGTATGTTACGTAGGATTGTCTT|TGCCTCTAAAACTTAACCTATGTAGGTCTG
CGCGGCGAGAACATGCAGGTTCCTTCGACC|GTGCACAATAGGTACAAAGACCTACCGGCT
GCGAGACGGGCCCGCGATTTGATTTAGGCT|ATTTAGGCTTGATCATTCGAGTACGTGCGC
CATCTAGGCTTTGTTATTTCGTAGTGATTT|GTACATTAATTACATCGAGATCTCAGAGTT
TTTGTTATTTCGTAGTGATTTAGGCTTGAT|TTACATCGAGATCTCAGAGTTATCCTGGCT
TAGTCAGCGTAACCAGGCCTATGGATGCGC|CGAAGTGGATACTAATACGCGTGGTCTAGC
CCGGCTAAGCTGTACCCTCTCCCCCTTGAC|CTGGATACGAGCAGCGCACACCCCAACGGT
GGCTTGATCATTCGAGTACGTGCAACGTAA|ATCATTCGAGTACGTGCCTCTATGACCACT
ATCTGAGTCAAGAAACTCCATGTAGGGATG|CGACCGAAGTTTTACTGGCCATGATAAAGT
TGGATGCGCTGAGCTATGATTTAGGCTTGA|TGGTCTAGCGGGTGCCCAACTCTGATCCCC
CTTGATCATTCGAGTACGTGCCTCTATGAC|CCGCCCGTGATTTAGGCTGATTTAGGCTTG
CCAGGCCTATGGATGCGCTGAGCTATGATT|TAATACGCGTGGTCTAGCGGGTGCCCAACT
AAGTGGATACTAATACGCGTGGTCTAGCGG|TACGTGCTTGATCATTCGAGTACTGATTTA
TGAACCTGGGCAACTGGGGAGTGATTTAGG|ATTCGAGTACGTGCTCGAGATGATTTAGGC
GCGTATGTTACGTAGGATTGTCTTAGTTTC|TAAAACTTAACCTATGTAGGTCTGATTTAG
TACGTGCCACCGTTAAAGATAAGTGATTTA|TAGCACAATGCGAATCTGAAAATCTAGGGT
TATAGTGTGCGGGGACGTGAGCCCGGAGAG|TACGTGCCCGAGGTTGATTTAGGCTTGATC
CTAATACGCGTGGTCTAGCGGGTGCCCAAC|GATCATTCGAGTACTGATTTAGGCTTGATC
TCTACGTGTATCTGAGTCAAGAAACTCCAT|AGGTTCCTTCGACCGAAGTTTTACTGGCCA
GTGTATCTGAGTCAAGAAACTCCATGTAGG|CCTTCGACCGAAGTTTTACTGGCCATGATA
GGCATCTAGGCTTTGTTATTTCGTAGTGAT|AGGTACATTAATTACATCGAGATCTCAGAG
CTCTCCCCAGACGATACTCTGATTTCAACG|AGTCAAGAAACTCCATGTAGGGATGATTTA
TGGCCATGATAAAGTTCAGTACGCTATGGG|CTCTCCCCCTTGACCTTCCGTCCTCCGGGT
AGTGGTATTCTAAGACACTTTCTGAAGGAC|ATCATTCGAGTACGTGCAGTCAGTTCGCCT
CAGGTCCCTCCAATATGCCGACTTAGGAAG|TAGTTTCGATGATTTAGGCTTGATCATTCG
ACCACTCCTTCGAAGTGGATACTAATACGC|TGATCATTCGAGTACGTGCTTGATCATTCG
CGTGCTTGATCATTCGAGTACTGATTTAGG|TCTGAAGGACACACCTCTGTGGGAAGCCAC
GATGATTTAGGCTTGATCATTCGAGTACGT|GCTTGATCATTCGAGTACGTGCAACGTAAT
ACGATACTCTGATTTCAACGCTGTTGCGAT|CTCCATGTAGGGATGATTTAGGCTTGATCA
GGCCTATGGATGCGCTGAGCTATGATTTAG|TACGCGTGGTCTAGCGGGTGCCCAACTCTG
ATTCGAGTACGTGCTTGATCATTCGAGTAC|AAGACACTTTCTGAAGGACACACCTCTGTG
GATGATTTAGGCTTGATCATTCGAGTACGT|GATTTAGGCTTGATCATTCGAGTACGTGCG
TGATAAAGTTCAGTACGCTATGGGTTCCTG|CCCTTGACCTTCCGTCCTCCGGGTATGCGA
GGTACAAAGACCTACCGGCTAAGCTGTACC|TTCTAGCTTGTGCTCTGGATACGAGCAGCG
TGATTTAGGCTTGATCATTCGAGTACGTGC|ATGCAAGTGGTATTCTAAGACACTTTCTGA
GAACATGCAGGTTCCTTCGACCGAAGTTTT|TAGGTACAAAGACCTACCGGCTAAGCTGTA
ACTTAACCTATGTAGGTCTGATTTAGGCTT|GTTAAAGATAAGTGATTTAGGCTTGATCAT
CTGATTTAGGCTTTGATTTAGGCTTGATCA|CGAAGATGCGCCCTATAAAACCTAACGGGT
ATTTAGGCTTTGATTTAGGCTTGATCATTC|AGATGCGCCCTATAAAACCTAACGGGTACA
TTGATCATTCGAGTACGTGCTTGATCATTC|TATTCTAAGACACTTTCTGAAGGACACACC
TTTACTGGCCATGATAAAGTTCAGTACGCT|GTACCCTCTCCCCCTTGACCTTCCGTCCTC
TGATCATTCGAGTACGTGCCATATAGATTT|CCTATGGATGCGCTGAGCTATGATTTAGGC
CGAGTACGTGCCACCGTTAAAGATAAGTGA|GCACTAGCACAATGCGAATCTGAAAATCTA
TCGAGTACGTGCAACGTAATTCCTAGTCAG|ACGTGCCTCTATGACCACTCCTTCGAAGTG
AGACACTTTCTGAAGGACACACCTCTGTGG|CGTGCAGTCAGTTCGCCTTGGCGTGTAGTC
GTGTAGTCCTCTACGTGTATCTGAGTCAAG|AGAACATGCAGGTTCCTTCGACCGAAGTTT
GCGCTGAGCTATGATTTAGGCTTGATCATT|TAGCGGGTGCCCAACTCTGATCCCCTTGTA
GTGGAGAAGGCCTGCCTCTAAAACTTAACC|GATCATTCGAGTACGTGCCACCGTTAAAGA
ATTCGAGTACGTGCGCATGTATCCAGGTCC|GCGTATGTTACGTAGGATTGTCTTAGTTTC
GGCTTGATCATTCGAGTACGTGCAGTCAGT|GCTTGATCATTCGAGTACGTGCAGCCGAGC
TTAAGGCATCTAGGCTTTGTTATTTCGTAG|GGGTAGGTACATTAATTACATCGAGATCTC
GAGTACGTGCGCATGTATCCAGGTCCCTCC|ATGTTACGTAGGATTGTCTTAGTTTCGATG
AGGCTTGATCATTCGAGTACGTGCGCATGT|ATCCTGGCTCGCGTATGTTACGTAGGATTG
TTCGAGTACGTGCGTGCAAGAAACGCTTGC|TCTCCCCAGACGATACTCTGATTTCAACGC
ATCGAGATCTCAGAGTTATCCTGGCTCGCG|TAGATTTCCGTGGAGAAGGCCTGCCTCTAA
TAGCACAATGCGAATCTGAAAATCTAGGGT|AGAAACGCTTGCTTTCCAAACCGTCGCAGT
TTTAGGCTTGATCATTCGAGTACGTGCCAC|CTCTGATCCCCTTGTAGCACTAGCACAATG
CAAGTGGTATTCTAAGACACTTTCTGAAGG|TGATCATTCGAGTACGTGCAGTCAGTTCGC
TGCAACGTAATTCCTAGTCAGCGTAACCAG|TATGACCACTCCTTCGAAGTGGATACTAAT
TTAGGCTTGATCATTCGAGTACGTGCCCGA|TCATTCGAGTACGTGCAACGTAATTCCTAG
GAAGTTTTACTGGCCATGATAAAGTTCAGT|AAGCTGTACCCTCTCCCCCTTGACCTTCCG
CAGGCCTATGGATGCGCTGAGCTATGATTT|AATACGCGTGGTCTAGCGGGTGCCCAACTC
CGAGTACGTGCACAATAGGTACAAAGACCT|ACAGGTACACCGAGGATTTCTAGCTTGTGC
ATTCGAGTACTGATTTAGGCTTGATCATTC|CACCTCTGTGGGAAGCCACGAAGACACTCT
GCTAAGCTGTACCCTCTCCCCCTTGACCTT|GATACGAGCAGCGCACACCCCAACGGTCCC
GAGTACGTGCTCGAGATGATTTAGGCTTGA|CTGATTTAGGCTTTGATTTAGGCTTGATCA
AGGGTAGGTACATTAATTACATCGAGATCT|TCATTCGAGTACGTGCCATATAGATTTCCG
CTTTGTTATTTCGTAGTGATTTAGGCTTGA|ATTACATCGAGATCTCAGAGTTATCCTGGC
TGATCATTCGAGTACTGATTTAGGCTTGAT|GGACACACCTCTGTGGGAAGCCACGAAGAC
ACGTGCGATCATTCGAGTACGTGCACAATA|CCGAAAACAGCGTACAGGTACACCGAGGAT
AGGATTGTCTTAGTTTCGATGATTTAGGCT|ATGTAGGTCTGATTTAGGCTTGATCATTCG
GATCTCAGAGTTATCCTGGCTCGCGTATGT|TTCCGTGGAGAAGGCCTGCCTCTAAAACTT
TTGTTATTTCGTAGTGATTTAGGCTTGATC|TACATCGAGATCTCAGAGTTATCCTGGCTC
GAGATGATTTAGGCTTGATCATTCGAGTAC|TTGATTTAGGCTTGATCATTCGAGTACGTG
TTACATCGAGATCTCAGAGTTATCCTGGCT|CATATAGATTTCCGTGGAGAAGGCCTGCCT
CTGATTTCAACGCTGTTGCGATGAACCTGG|AGGGATGATTTAGGCTTGATCATTCGAGTA
GGCGAGAACATGCAGGTTCCTTCGACCGAA|CACAATAGGTACAAAGACCTACCGGCTAAG
TCGAGTACGTGCGATCATTCGAGTACGTGC|CATTAGCCGAAAACAGCGTACAGGTACACC
GATCATTCGAGTACGTGCAGTCAGTTCGCC|ATCATTCGAGTACGTGCAGCCGAGCCTACG
GAGGTTGATTTAGGCTTGATCATTCGAGTA|AGTCAGCGTAACCAGGCCTATGGATGCGCT
GATAAAGTTCAGTACGCTATGGGTTCCTGA|CCTTGACCTTCCGTCCTCCGGGTATGCGAA
ATAGATTTCCGTGGAGAAGGCCTGCCTCTA|ATTTAGGCTTGATCATTCGAGTACGTGCCA
CCATGATAAAGTTCAGTACGCTATGGGTTC|TCCCCCTTGACCTTCCGTCCTCCGGGTATG
CACCTCTGTGGGAAGCCACGAAGACACTCT|GGCGTGTAGTCCTCTACGTGTATCTGAGTC
GAAAATCTAGGGTTCCCGCCCGTGATTTAG|AAACCGTCGCAGTCTTCAACGTAGCATAGC
GTAGGTCTGATTTAGGCTTGATCATTCGAG|GTGATTTAGGCTTGATCATTCGAGTACGTG
ATGTAGGGATGATTTAGGCTTGATCATTCG|CATGATAAAGTTCAGTACGCTATGGGTTCC
ATTTAGGCTTGATCATTCGAGTACGTGCCA|ACTCTGATCCCCTTGTAGCACTAGCACAAT
GCGCATGTATCCAGGTCCCTCCAATATGCC|TAGGATTGTCTTAGTTTCGATGATTTAGGC
AGCGTAACCAGGCCTATGGATGCGCTGAGC|TGGATACTAATACGCGTGGTCTAGCGGGTG
ATTCCTAGTCAGCGTAACCAGGCCTATGGA|TCCTTCGAAGTGGATACTAATACGCGTGGT
GTGCGGGGACGTGAGCCCGGAGAGGGTAGG|CCCGAGGTTGATTTAGGCTTGATCATTCGA
TCTGATCCCCTTGTAGCACTAGCACAATGC|ATTCGAGTACGTGCGTGCAAGAAACGCTTG
CCGAGCCTACGCGGCGAGAACATGCAGGTT|TTCGAGTACGTGCACAATAGGTACAAAGAC
ACGTGCAGCCGAGCCTACGCGGCGAGAACA|TGCGATCATTCGAGTACGTGCACAATAGGT
TGATCATTCGAGTACGTGCCCGAGGTTGAT|AGTACGTGCAACGTAATTCCTAGTCAGCGT
ATATAGTGTGCGGGGACGTGAGCCCGGAGA|GTACGTGCCCGAGGTTGATTTAGGCTTGAT
AGGCTTGATCATTCGAGTACGTGCGTGCAA|CACGAAGACACTCTCCCCAGACGATACTCT
GTACGTGCAGCCGAGCCTACGCGGCGAGAA|CGTGCGATCATTCGAGTACGTGCACAATAG
AAGCCACGAAGACACTCTCCCCAGACGATA|TCTACGTGTATCTGAGTCAAGAAACTCCAT
TCAGTACGCTATGGGTTCCTGATTTAGGCT|TTCCGTCCTCCGGGTATGCGAAGATGCGCC
GAGTACGTGCACAATAGGTACAAAGACCTA|CAGGTACACCGAGGATTTCTAGCTTGTGCT
ATTCGAGTACGTGCCTCTATGACCACTCCT|TGATTTAGGCTGATTTAGGCTTGATCATTC
TACTGGCCATGATAAAGTTCAGTACGCTAT|ACCCTCTCCCCCTTGACCTTCCGTCCTCCG
TAGGCTTTGTTATTTCGTAGTGATTTAGGC|ATTAATTACATCGAGATCTCAGAGTTATCC
TACCGGCTAAGCTGTACCCTCTCCCCCTTG|CTCTGGATACGAGCAGCGCACACCCCAACG
CACTCTCCCCAGACGATACTCTGATTTCAA|TGAGTCAAGAAACTCCATGTAGGGATGATT
ATTAACTATCCGCGTAGAGTTCGCCGATTA|TATGCCGACTTAGGAAGAATATAGTGTGCG
ACGTAGGATTGTCTTAGTTTCGATGATTTA|ACCTATGTAGGTCTGATTTAGGCTTGATCA
TTAGGCTTGATCATTCGAGTACGTGCGCAT|TTATCCTGGCTCGCGTATGTTACGTAGGAT
AACTGGGGAGTGATTTAGGCTTGATCATTC|TGCTCGAGATGATTTAGGCTTGATCATTCG
GCGAATCTGAAAATCTAGGGTTCCCGCCCG|TGCTTTCCAAACCGTCGCAGTCTTCAACGT
ATTCGAGTACGTGCTCGAGATGATTTAGGC|GTTCCTGATTTAGGCTTTGATTTAGGCTTG
GCTTGATCATTCGAGTACGTGCAGCCGAGC|TGATCATTCGAGTACGTGCGATCATTCGAG
AATTCCTAGTCAGCGTAACCAGGCCTATGG|CTCCTTCGAAGTGGATACTAATACGCGTGG
TAAGGCATCTAGGCTTTGTTATTTCGTAGT|GGTAGGTACATTAATTACATCGAGATCTCA
CTCTGATTTCAACGCTGTTGCGATGAACCT|GTAGGGATGATTTAGGCTTGATCATTCGAG
GTACGTGCCTCTATGACCACTCCTTCGAAG|AGGCTGATTTAGGCTTGATCATTCGAGTAC
TACTCAAACGCCGTTAAGGCATCTAGGCTT|GTGAGCCCGGAGAGGGTAGGTACATTAATT
CAGTACGCTATGGGTTCCTGATTTAGGCTT|TCCGTCCTCCGGGTATGCGAAGATGCGCCC
TGCTTGATCATTCGAGTACTGATTTAGGCT|TGAAGGACACACCTCTGTGGGAAGCCACGA
CATGTATCCAGGTCCCTCCAATATGCCGAC|GATTGTCTTAGTTTCGATGATTTAGGCTTG
ATGACCACTCCTTCGAAGTGGATACTAATA|GCTTGATCATTCGAGTACGTGCTTGATCAT
CGTTAAGGCATCTAGGCTTTGTTATTTCGT|GAGGGTAGGTACATTAATTACATCGAGATC
TCGAAGTGGATACTAATACGCGTGGTCTAG|GAGTACGTGCTTGATCATTCGAGTACTGAT
GCAGTCTTCAACGTAGCATAGCACATGCAA|CTGGGCAACTGGGGAGTGATTTAGGCTTGA
GCCTTGGCGTGTAGTCCTCTACGTGTATCT|ACGCGGCGAGAACATGCAGGTTCCTTCGAC
AACGTAGCATAGCACATGCAAGTGGTATTC|TGGGGAGTGATTTAGGCTTGATCATTCGAG
AGACGGGCCCGCGATTTGATTTAGGCTTGA|TAGGCTTGATCATTCGAGTACGTGCGCATG
AAGGCCTGCCTCTAAAACTTAACCTATGTA|TCGAGTACGTGCCACCGTTAAAGATAAGTG
TATGTTACGTAGGATTGTCTTAGTTTCGAT|AACTTAACCTATGTAGGTCTGATTTAGGCT
CAGTCAGTTCGCCTTGGCGTGTAGTCCTCT|AGCCGAGCCTACGCGGCGAGAACATGCAGG
CTCGCGTATGTTACGTAGGATTGTCTTAGT|CTCTAAAACTTAACCTATGTAGGTCTGATT
TGTAGTCCTCTACGTGTATCTGAGTCAAGA|GAACATGCAGGTTCCTTCGACCGAAGTTTT
TTCGCCGATTAATGTCTACTCAAACGCCGT|TATAGTGTGCGGGGACGTGAGCCCGGAGAG
CTTGATCATTCGAGTACGTGCCATATAGAT|GGCCTATGGATGCGCTGAGCTATGATTTAG
AGCCACGAAGACACTCTCCCCAGACGATAC|CTACGTGTATCTGAGTCAAGAAACTCCATG
TCTATGACCACTCCTTCGAAGTGGATACTA|TAGGCTTGATCATTCGAGTACGTGCTTGAT
AGGTACAAAGACCTACCGGCTAAGCTGTAC|TTTCTAGCTTGTGCTCTGGATACGAGCAGC
CGAGGTTGATTTAGGCTTGATCATTCGAGT|TAGTCAGCGTAACCAGGCCTATGGATGCGC
CGATCATTCGAGTACGTGCACAATAGGTAC|AACAGCGTACAGGTACACCGAGGATTTCTA
TTTCCAAACCGTCGCAGTCTTCAACGTAGC|TGTTGCGATGAACCTGGGCAACTGGGGAGT
GATGCGCTGAGCTATGATTTAGGCTTGATC|GTCTAGCGGGTGCCCAACTCTGATCCCCTT
CCGACTTAGGAAGAATATAGTGTGCGGGGA|GCTTGATCATTCGAGTACGTGCCCGAGGTT
CCTCTACGTGTATCTGAGTCAAGAAACTCC|GCAGGTTCCTTCGACCGAAGTTTTACTGGC
TGTCTTAGTTTCGATGATTTAGGCTTGATC|GGTCTGATTTAGGCTTGATCATTCGAGTAC
TAGCACATGCAAGTGGTATTCTAAGACACT|ATTTAGGCTTGATCATTCGAGTACGTGCAG
AGTACGTGCAGCCGAGCCTACGCGGCGAGA|ACGTGCGATCATTCGAGTACGTGCACAATA
CAGTCTTCAACGTAGCATAGCACATGCAAG|TGGGCAACTGGGGAGTGATTTAGGCTTGAT
AACGCTGTTGCGATGAACCTGGGCAACTGG|TTTAGGCTTGATCATTCGAGTACGTGCTCG
TCGCGTATGTTACGTAGGATTGTCTTAGTT|TCTAAAACTTAACCTATGTAGGTCTGATTT
TAACTATCCGCGTAGAGTTCGCCGATTAAT|TGCCGACTTAGGAAGAATATAGTGTGCGGG
TCAGAGTTATCCTGGCTCGCGTATGTTACG|GTGGAGAAGGCCTGCCTCTAAAACTTAACC
CTACGTGTATCTGAGTCAAGAAACTCCATG|GGTTCCTTCGACCGAAGTTTTACTGGCCAT
CCCGCCCGTGATTTAGGCTGATTTAGGCTT|TTCAACGTAGCATAGCACATGCAAGTGGTA
CTGAAAATCTAGGGTTCCCGCCCGTGATTT|CCAAACCGTCGCAGTCTTCAACGTAGCATA
CACATGCAAGTGGTATTCTAAGACACTTTC|TAGGCTTGATCATTCGAGTACGTGCAGTCA
TGAAAATCTAGGGTTCCCGCCCGTGATTTA|CAAACCGTCGCAGTCTTCAACGTAGCATAG
GGCCTGCCTCTAAAACTTAACCTATGTAGG|GAGTACGTGCCACCGTTAAAGATAAGTGAT
TAGGCTTGATCATTCGAGTACGTGCCCGAG|CATTCGAGTACGTGCAACGTAATTCCTAGT
TGGGAAGCCACGAAGACACTCTCCCCAGAC|GTCCTCTACGTGTATCTGAGTCAAGAAACT
GATCCCCTTGTAGCACTAGCACAATGCGAA|CGAGTACGTGCGTGCAAGAAACGCTTGCTT
ATCCGCGTAGAGTTCGCCGATTAATGTCTA|ACTTAGGAAGAATATAGTGTGCGGGGACGT
TGATTTCAACGCTGTTGCGATGAACCTGGG|GGGATGATTTAGGCTTGATCATTCGAGTAC
ACTTAGGAAGAATATAGTGTGCGGGGACGT|TGATCATTCGAGTACGTGCCCGAGGTTGAT
AGGCTTGATCATTCGAGTACGTGCAGCCGA|CTTGATCATTCGAGTACGTGCGATCATTCG
TGATTTAGGCTTGATCATTCGAGTACGTGC|GGAAGCCACGAAGACACTCTCCCCAGACGA
CCACCGTTAAAGATAAGTGATTTAGGCTTG|AATGCGAATCTGAAAATCTAGGGTTCCCGC
TACGTAGGATTGTCTTAGTTTCGATGATTT|AACCTATGTAGGTCTGATTTAGGCTTGATC
AGTACGTGCAACGTAATTCCTAGTCAGCGT|TGCCTCTATGACCACTCCTTCGAAGTGGAT
ACACTCTCCCCAGACGATACTCTGATTTCA|CTGAGTCAAGAAACTCCATGTAGGGATGAT
CGGGGACGTGAGCCCGGAGAGGGTAGGTAC|GAGGTTGATTTAGGCTTGATCATTCGAGTA
CCATGTAGGGATGATTTAGGCTTGATCATT|GCCATGATAAAGTTCAGTACGCTATGGGTT
TGTAGGGATGATTTAGGCTTGATCATTCGA|ATGATAAAGTTCAGTACGCTATGGGTTCCT
AGAACATGCAGGTTCCTTCGACCGAAGTTT|ATAGGTACAAAGACCTACCGGCTAAGCTGT
AGGCCTATGGATGCGCTGAGCTATGATTTA|ATACGCGTGGTCTAGCGGGTGCCCAACTCT
TCTACTCAAACGCCGTTAAGGCATCTAGGC|ACGTGAGCCCGGAGAGGGTAGGTACATTAA
CATGCAAGTGGTATTCTAAGACACTTTCTG|GGCTTGATCATTCGAGTACGTGCAGTCAGT
TGTAGCACTAGCACAATGCGAATCTGAAAA|TGCGTGCAAGAAACGCTTGCTTTCCAAACC
CCGTCGCAGTCTTCAACGTAGCATAGCACA|TGAACCTGGGCAACTGGGGAGTGATTTAGG
AGAAACGCTTGCTTTCCAAACCGTCGCAGT|TGATTTCAACGCTGTTGCGATGAACCTGGG
CATTAACTATCCGCGTAGAGTTCGCCGATT|ATATGCCGACTTAGGAAGAATATAGTGTGC
TTGATCATTCGAGTACGTGCAACGTAATTC|ATTCGAGTACGTGCCTCTATGACCACTCCT
GTGCAGTCAGTTCGCCTTGGCGTGTAGTCC|TGCAGCCGAGCCTACGCGGCGAGAACATGC
TTCGACCGAAGTTTTACTGGCCATGATAAA|ACCGGCTAAGCTGTACCCTCTCCCCCTTGA
CAGACGATACTCTGATTTCAACGCTGTTGC|AAACTCCATGTAGGGATGATTTAGGCTTGA
ATTCGAGTACGTGCAGCCGAGCCTACGCGG|CGAGTACGTGCGATCATTCGAGTACGTGCA
GCTTGATCATTCGAGTACGTGCCATATAGA|AGGCCTATGGATGCGCTGAGCTATGATTTA
GATACTCTGATTTCAACGCTGTTGCGATGA|CCATGTAGGGATGATTTAGGCTTGATCATT
CGAGAACATGCAGGTTCCTTCGACCGAAGT|CAATAGGTACAAAGACCTACCGGCTAAGCT
GAGAGGGTAGGTACATTAATTACATCGAGA|TGATCATTCGAGTACGTGCCATATAGATTT
TTCGAAGTGGATACTAATACGCGTGGTCTA|CGAGTACGTGCTTGATCATTCGAGTACTGA
AGTCAAGAAACTCCATGTAGGGATGATTTA|GAAGTTTTACTGGCCATGATAAAGTTCAGT
CTTGATCATTCGAGTACGTGCCCGAGGTTG|CGAGTACGTGCAACGTAATTCCTAGTCAGC
CCTCTAAAACTTAACCTATGTAGGTCTGAT|GTGCCACCGTTAAAGATAAGTGATTTAGGC
CGATTAATGTCTACTCAAACGCCGTTAAGG|TGTGCGGGGACGTGAGCCCGGAGAGGGTAG
AACATGCAGGTTCCTTCGACCGAAGTTTTA|AGGTACAAAGACCTACCGGCTAAGCTGTAC
TGCAAGAAACGCTTGCTTTCCAAACCGTCG|ACTCTGATTTCAACGCTGTTGCGATGAACC
CGACTTAGGAAGAATATAGTGTGCGGGGAC|CTTGATCATTCGAGTACGTGCCCGAGGTTG
AGATTTCCGTGGAGAAGGCCTGCCTCTAAA|TTAGGCTTGATCATTCGAGTACGTGCCACC
GTTCGCCGATTAATGTCTACTCAAACGCCG|ATATAGTGTGCGGGGACGTGAGCCCGGAGA
GCTGAGCTATGATTTAGGCTTGATCATTCG|GCGGGTGCCCAACTCTGATCCCCTTGTAGC
GCCACCGTTAAAGATAAGTGATTTAGGCTT|CAATGCGAATCTGAAAATCTAGGGTTCCCG
GACACACCTCTGTGGGAAGCCACGAAGACA|CCTTGGCGTGTAGTCCTCTACGTGTATCTG
GCAACGTAATTCCTAGTCAGCGTAACCAGG|ATGACCACTCCTTCGAAGTGGATACTAATA
GATCATTCGAGTACGTGCTTGATCATTCGA|TTCTAAGACACTTTCTGAAGGACACACCTC
CAACGTAATTCCTAGTCAGCGTAACCAGGC|TGACCACTCCTTCGAAGTGGATACTAATAC
GTACGTGCAACGTAATTCCTAGTCAGCGTA|GCCTCTATGACCACTCCTTCGAAGTGGATA
GTGCCCAACTCTGATCCCCTTGTAGCACTA|GGCTTGATCATTCGAGTACGTGCGTGCAAG
AGAGTTATCCTGGCTCGCGTATGTTACGTA|GGAGAAGGCCTGCCTCTAAAACTTAACCTA
GTTGATTTAGGCTTGATCATTCGAGTACGT|CAGCGTAACCAGGCCTATGGATGCGCTGAG
ACCGGCTAAGCTGTACCCTCTCCCCCTTGA|TCTGGATACGAGCAGCGCACACCCCAACGG
CCAAACCGTCGCAGTCTTCAACGTAGCATA|TGCGATGAACCTGGGCAACTGGGGAGTGAT
CCTATGTAGGTCTGATTTAGGCTTGATCAT|GATAAGTGATTTAGGCTTGATCATTCGAGT
GCTTTGTTATTTCGTAGTGATTTAGGCTTG|AATTACATCGAGATCTCAGAGTTATCCTGG
GCGGGTGCCCAACTCTGATCCCCTTGTAGC|TTTAGGCTTGATCATTCGAGTACGTGCGTG
ATTTAGGCTTGATCATTCGAGTACGTGCTT|GCAAGTGGTATTCTAAGACACTTTCTGAAG
AGTACGTGCTTGATCATTCGAGTACTGATT|ACTTTCTGAAGGACACACCTCTGTGGGAAG
TGCCCGAGGTTGATTTAGGCTTGATCATTC|TTCCTAGTCAGCGTAACCAGGCCTATGGAT
GAGAAGGCCTGCCTCTAAAACTTAACCTAT|CATTCGAGTACGTGCCACCGTTAAAGATAA
GCTTGATCATTCGAGTACGTGCCATTAACT|CGCATGTATCCAGGTCCCTCCAATATGCCG
CCCTCCAATATGCCGACTTAGGAAGAATAT|TCGATGATTTAGGCTTGATCATTCGAGTAC
GAGTACGTGCCATTAACTATCCGCGTAGAG|GGTCCCTCCAATATGCCGACTTAGGAAGAA
TCCAATATGCCGACTTAGGAAGAATATAGT|ATGATTTAGGCTTGATCATTCGAGTACGTG
GCTTGATCATTCGAGTACGTGCGATCATTC|CTAACGGGTACATTAGCCGAAAACAGCGTA
TGTTACGTAGGATTGTCTTAGTTTCGATGA|CTTAACCTATGTAGGTCTGATTTAGGCTTG
AGTGTGCGGGGACGTGAGCCCGGAGAGGGT|GTGCCCGAGGTTGATTTAGGCTTGATCATT
CTCTATGACCACTCCTTCGAAGTGGATACT|TTAGGCTTGATCATTCGAGTACGTGCTTGA
CACTCCTTCGAAGTGGATACTAATACGCGT|ATCATTCGAGTACGTGCTTGATCATTCGAG
ATGATAAAGTTCAGTACGCTATGGGTTCCT|CCCCTTGACCTTCCGTCCTCCGGGTATGCG
GATTTGATTTAGGCTTGATCATTCGAGTAC|TTCGAGTACGTGCGCATGTATCCAGGTCCC
TTCGATGATTTAGGCTTGATCATTCGAGTA|TAGGCTTGATCATTCGAGTACGTGCAACGT
ATTTCGTAGTGATTTAGGCTTGATCATTCG|CGAGATCTCAGAGTTATCCTGGCTCGCGTA
TAAGCTGTACCCTCTCCCCCTTGACCTTCC|TACGAGCAGCGCACACCCCAACGGTCCCGG
AAGAAACGCTTGCTTTCCAAACCGTCGCAG|CTGATTTCAACGCTGTTGCGATGAACCTGG
CTACTCAAACGCCGTTAAGGCATCTAGGCT|CGTGAGCCCGGAGAGGGTAGGTACATTAAT
CTTGATCATTCGAGTACGTGCCATTAACTA|GCATGTATCCAGGTCCCTCCAATATGCCGA
ATCTGAAAATCTAGGGTTCCCGCCCGTGAT|TTCCAAACCGTCGCAGTCTTCAACGTAGCA
GCCTATGGATGCGCTGAGCTATGATTTAGG|ACGCGTGGTCTAGCGGGTGCCCAACTCTGA
CGTAACCAGGCCTATGGATGCGCTGAGCTA|GATACTAATACGCGTGGTCTAGCGGGTGCC
ACCGTCGCAGTCTTCAACGTAGCATAGCAC|ATGAACCTGGGCAACTGGGGAGTGATTTAG
GTACAAAGACCTACCGGCTAAGCTGTACCC|TCTAGCTTGTGCTCTGGATACGAGCAGCGC
GCCTCTATGACCACTCCTTCGAAGTGGATA|ATTTAGGCTTGATCATTCGAGTACGTGCTT
ACCGTTAAAGATAAGTGATTTAGGCTTGAT|TGCGAATCTGAAAATCTAGGGTTCCCGCCC
GAGTACGTGCAGCCGAGCCTACGCGGCGAG|TACGTGCGATCATTCGAGTACGTGCACAAT
GGCTTGATCATTCGAGTACGTGCCCGAGGT|TTCGAGTACGTGCAACGTAATTCCTAGTCA
CAAGAAACTCCATGTAGGGATGATTTAGGC|GTTTTACTGGCCATGATAAAGTTCAGTACG
CCCAACTCTGATCCCCTTGTAGCACTAGCA|TTGATCATTCGAGTACGTGCGTGCAAGAAA
GTGATTTAGGCTTGATCATTCGAGTACGTG|TGATTTAGGCTTGATCATTCGAGTACGTGC
TTCGAGTACGTGCTCGAGATGATTTAGGCT|TTCCTGATTTAGGCTTTGATTTAGGCTTGA
CAATGCGAATCTGAAAATCTAGGGTTCCCG|CGCTTGCTTTCCAAACCGTCGCAGTCTTCA
TCAGTTCGCCTTGGCGTGTAGTCCTCTACG|CGAGCCTACGCGGCGAGAACATGCAGGTTC
CTTGATCATTCGAGTACGTGCCACCGTTAA|TCCCCTTGTAGCACTAGCACAATGCGAATC
CGAGTACGTGCGATCATTCGAGTACGTGCA|ATTAGCCGAAAACAGCGTACAGGTACACCG
CCTGGGCAACTGGGGAGTGATTTAGGCTTG|GAGTACGTGCTCGAGATGATTTAGGCTTGA
AATCTGAAAATCTAGGGTTCCCGCCCGTGA|TTTCCAAACCGTCGCAGTCTTCAACGTAGC
GAGTACTGATTTAGGCTTGATCATTCGAGT|TCTGTGGGAAGCCACGAAGACACTCTCCCC
TTTCGTAGTGATTTAGGCTTGATCATTCGA|GAGATCTCAGAGTTATCCTGGCTCGCGTAT
TTGATTTAGGCTTGATCATTCGAGTACGTG|CTATAAAACCTAACGGGTACATTAGCCGAA
TGCAGCCGAGCCTACGCGGCGAGAACATGC|GATCATTCGAGTACGTGCACAATAGGTACA
CTCCATGTAGGGATGATTTAGGCTTGATCA|TGGCCATGATAAAGTTCAGTACGCTATGGG
GGATACTAATACGCGTGGTCTAGCGGGTGC|TGCTTGATCATTCGAGTACTGATTTAGGCT
GACCTACCGGCTAAGCTGTACCCTCTCCCC|TGTGCTCTGGATACGAGCAGCGCACACCCC
TTAGGCTTGATCATTCGAGTACGTGCTTGA|AAGTGGTATTCTAAGACACTTTCTGAAGGA
CTTGATCATTCGAGTACGTGCTCGAGATGA|GCTATGGGTTCCTGATTTAGGCTTTGATTT
GCTATGGGTTCCTGATTTAGGCTTTGATTT|CTCCGGGTATGCGAAGATGCGCCCTATAAA
TAGGCTTGATCATTCGAGTACGTGCTCGAG|GTACGCTATGGGTTCCTGATTTAGGCTTTG
GTACGTGCGATCATTCGAGTACGTGCACAA|AGCCGAAAACAGCGTACAGGTACACCGAGG
TCCCTCCAATATGCCGACTTAGGAAGAATA|TTCGATGATTTAGGCTTGATCATTCGAGTA
ACGTGCAGTCAGTTCGCCTTGGCGTGTAGT|CGTGCAGCCGAGCCTACGCGGCGAGAACAT
TATGACCACTCCTTCGAAGTGGATACTAAT|GGCTTGATCATTCGAGTACGTGCTTGATCA
ATTTAGGCTTGATCATTCGAGTACGTGCCA|GTAACCAGGCCTATGGATGCGCTGAGCTAT
TTATTTCGTAGTGATTTAGGCTTGATCATT|ATCGAGATCTCAGAGTTATCCTGGCTCGCG
ATTACATCGAGATCTCAGAGTTATCCTGGC|CCATATAGATTTCCGTGGAGAAGGCCTGCC
ATGCGAATCTGAAAATCTAGGGTTCCCGCC|CTTGCTTTCCAAACCGTCGCAGTCTTCAAC
ATCATTCGAGTACGTGCAGCCGAGCCTACG|ATTCGAGTACGTGCGATCATTCGAGTACGT
TTCTAAGACACTTTCTGAAGGACACACCTC|GAGTACGTGCAGTCAGTTCGCCTTGGCGTG
GCATCTAGGCTTTGTTATTTCGTAGTGATT|GGTACATTAATTACATCGAGATCTCAGAGT
ATTTAGGCTTGATCATTCGAGTACGTGCAA|GCTTGATCATTCGAGTACGTGCCTCTATGA
ACAAAGACCTACCGGCTAAGCTGTACCCTC|TAGCTTGTGCTCTGGATACGAGCAGCGCAC
CTTCGACCGAAGTTTTACTGGCCATGATAA|TACCGGCTAAGCTGTACCCTCTCCCCCTTG
ATCATTCGAGTACGTGCCCGAGGTTGATTT|TACGTGCAACGTAATTCCTAGTCAGCGTAA
AGGAAGAATATAGTGTGCGGGGACGTGAGC|CATTCGAGTACGTGCCCGAGGTTGATTTAG
ATTTAGGCTTGATCATTCGAGTACGTGCCC|GATCATTCGAGTACGTGCAACGTAATTCCT
CTAGGCTTTGTTATTTCGTAGTGATTTAGG|CATTAATTACATCGAGATCTCAGAGTTATC
TCATTCGAGTACGTGCAACGTAATTCCTAG|GAGTACGTGCCTCTATGACCACTCCTTCGA
TCATTCGAGTACGTGCCATTAACTATCCGC|TATCCAGGTCCCTCCAATATGCCGACTTAG
CTCTACGTGTATCTGAGTCAAGAAACTCCA|CAGGTTCCTTCGACCGAAGTTTTACTGGCC
ATGCGCTGAGCTATGATTTAGGCTTGATCA|TCTAGCGGGTGCCCAACTCTGATCCCCTTG
TCCTGGCTCGCGTATGTTACGTAGGATTGT|GCCTGCCTCTAAAACTTAACCTATGTAGGT
GCGATTTGATTTAGGCTTGATCATTCGAGT|CATTCGAGTACGTGCGCATGTATCCAGGTC
ATTTGATTTAGGCTTGATCATTCGAGTACG|TCGAGTACGTGCGCATGTATCCAGGTCCCT
GCTTGATCATTCGAGTACGTGCAACGTAAT|TCATTCGAGTACGTGCCTCTATGACCACTC
TAGGCTTTGATTTAGGCTTGATCATTCGAG|TGCGCCCTATAAAACCTAACGGGTACATTA
TTTAGGCTTGATCATTCGAGTACGTGCCTC|GGGTTCCCGCCCGTGATTTAGGCTGATTTA
GATTTAGGCTTGATCATTCGAGTACGTGCA|ATTTAGGCTTGATCATTCGAGTACGTGCAG
GACGTGAGCCCGGAGAGGGTAGGTACATTA|TTGATTTAGGCTTGATCATTCGAGTACGTG
AGAAGGCCTGCCTCTAAAACTTAACCTATG|ATTCGAGTACGTGCCACCGTTAAAGATAAG
GCCCGAGGTTGATTTAGGCTTGATCATTCG|TCCTAGTCAGCGTAACCAGGCCTATGGATG
CGTGCCATATAGATTTCCGTGGAGAAGGCC|GAGCTATGATTTAGGCTTGATCATTCGAGT
GACCGAAGTTTTACTGGCCATGATAAAGTT|GGCTAAGCTGTACCCTCTCCCCCTTGACCT
GTTCCCGCCCGTGATTTAGGCTGATTTAGG|GTCTTCAACGTAGCATAGCACATGCAAGTG
GCCGATTAATGTCTACTCAAACGCCGTTAA|AGTGTGCGGGGACGTGAGCCCGGAGAGGGT
TATTTCGTAGTGATTTAGGCTTGATCATTC|TCGAGATCTCAGAGTTATCCTGGCTCGCGT
TATTCTAAGACACTTTCTGAAGGACACACC|TCGAGTACGTGCAGTCAGTTCGCCTTGGCG
GGTCTGATTTAGGCTTGATCATTCGAGTAC|ATTTAGGCTTGATCATTCGAGTACGTGCCT
ATAGGTACAAAGACCTACCGGCTAAGCTGT|GATTTCTAGCTTGTGCTCTGGATACGAGCA
GAGTGATTTAGGCTTGATCATTCGAGTACG|GATGATTTAGGCTTGATCATTCGAGTACGT
TACTAATACGCGTGGTCTAGCGGGTGCCCA|TTGATCATTCGAGTACTGATTTAGGCTTGA
ACGGGCCCGCGATTTGATTTAGGCTTGATC|GGCTTGATCATTCGAGTACGTGCGCATGTA
ACGAAGACACTCTCCCCAGACGATACTCTG|GTGTATCTGAGTCAAGAAACTCCATGTAGG
GCTTGATCATTCGAGTACGTGCCCGAGGTT|TCGAGTACGTGCAACGTAATTCCTAGTCAG
AACGCCGTTAAGGCATCTAGGCTTTGTTAT|CCGGAGAGGGTAGGTACATTAATTACATCG
TGCTTTCCAAACCGTCGCAGTCTTCAACGT|CGCTGTTGCGATGAACCTGGGCAACTGGGG
CATTCGAGTACGTGCAACGTAATTCCTAGT|AGTACGTGCCTCTATGACCACTCCTTCGAA
AGGTACATTAATTACATCGAGATCTCAGAG|CGAGTACGTGCCATATAGATTTCCGTGGAG
CAGCGTAACCAGGCCTATGGATGCGCTGAG|GTGGATACTAATACGCGTGGTCTAGCGGGT
TGATTTAGGCTTGATCATTCGAGTACGTGC|TTTAGGCTTGATCATTCGAGTACGTGCGAT
GTTCAGTACGCTATGGGTTCCTGATTTAGG|CCTTCCGTCCTCCGGGTATGCGAAGATGCG
GGTCTAGCGGGTGCCCAACTCTGATCCCCT|TACTGATTTAGGCTTGATCATTCGAGTACG
AGAGGGTAGGTACATTAATTACATCGAGAT|GATCATTCGAGTACGTGCCATATAGATTTC
GAAGAATATAGTGTGCGGGGACGTGAGCCC|TTCGAGTACGTGCCCGAGGTTGATTTAGGC
GGGCAACTGGGGAGTGATTTAGGCTTGATC|TACGTGCTCGAGATGATTTAGGCTTGATCA
AGGCTTGATCATTCGAGTACGTGCAACGTA|GATCATTCGAGTACGTGCCTCTATGACCAC
AAGATAAGTGATTTAGGCTTGATCATTCGA|CTGAAAATCTAGGGTTCCCGCCCGTGATTT
TTTAGGCTTGATCATTCGAGTACGTGCGAT|AAAACCTAACGGGTACATTAGCCGAAAACA
TTCGAGTACGTGCCTCTATGACCACTCCTT|GATTTAGGCTGATTTAGGCTTGATCATTCG
ACGTGCCATATAGATTTCCGTGGAGAAGGC|TGAGCTATGATTTAGGCTTGATCATTCGAG
AACCGTCGCAGTCTTCAACGTAGCATAGCA|GATGAACCTGGGCAACTGGGGAGTGATTTA
AGTACGTGCGATCATTCGAGTACGTGCACA|TAGCCGAAAACAGCGTACAGGTACACCGAG
TGAGTCAAGAAACTCCATGTAGGGATGATT|CCGAAGTTTTACTGGCCATGATAAAGTTCA
TTGATCATTCGAGTACGTGCGTGCAAGAAA|AAGACACTCTCCCCAGACGATACTCTGATT
GGCCATGATAAAGTTCAGTACGCTATGGGT|TCTCCCCCTTGACCTTCCGTCCTCCGGGTA
AGGTCCCTCCAATATGCCGACTTAGGAAGA|AGTTTCGATGATTTAGGCTTGATCATTCGA
CGTGTATCTGAGTCAAGAAACTCCATGTAG|TCCTTCGACCGAAGTTTTACTGGCCATGAT
CCGAGGTTGATTTAGGCTTGATCATTCGAG|CTAGTCAGCGTAACCAGGCCTATGGATGCG
GATTAATGTCTACTCAAACGCCGTTAAGGC|GTGCGGGGACGTGAGCCCGGAGAGGGTAGG
CTCCTTCGAAGTGGATACTAATACGCGTGG|CATTCGAGTACGTGCTTGATCATTCGAGTA
GTTGCGATGAACCTGGGCAACTGGGGAGTG|CTTGATCATTCGAGTACGTGCTCGAGATGA
TCCGCGTAGAGTTCGCCGATTAATGTCTAC|CTTAGGAAGAATATAGTGTGCGGGGACGTG
CACTTTCTGAAGGACACACCTCTGTGGGAA|GCAGTCAGTTCGCCTTGGCGTGTAGTCCTC
CGTGCAACGTAATTCCTAGTCAGCGTAACC|TCTATGACCACTCCTTCGAAGTGGATACTA
GTTATCCTGGCTCGCGTATGTTACGTAGGA|GAAGGCCTGCCTCTAAAACTTAACCTATGT
TAAGTGATTTAGGCTTGATCATTCGAGTAC|AAATCTAGGGTTCCCGCCCGTGATTTAGGC
TTAATTACATCGAGATCTCAGAGTTATCCT|GTGCCATATAGATTTCCGTGGAGAAGGCCT
GGCAACTGGGGAGTGATTTAGGCTTGATCA|ACGTGCTCGAGATGATTTAGGCTTGATCAT
TCCTCTACGTGTATCTGAGTCAAGAAACTC|TGCAGGTTCCTTCGACCGAAGTTTTACTGG
TTTAGGCTTGATCATTCGAGTACGTGCTCG|CAGTACGCTATGGGTTCCTGATTTAGGCTT
ACCGAAGTTTTACTGGCCATGATAAAGTTC|GCTAAGCTGTACCCTCTCCCCCTTGACCTT
TTCCTGATTTAGGCTTTGATTTAGGCTTGA|ATGCGAAGATGCGCCCTATAAAACCTAACG
GCCGAGCCTACGCGGCGAGAACATGCAGGT|ATTCGAGTACGTGCACAATAGGTACAAAGA
TCATTCGAGTACGTGCCACCGTTAAAGATA|TTGTAGCACTAGCACAATGCGAATCTGAAA
TAGGCTTGATCATTCGAGTACGTGCAGCCG|GCTTGATCATTCGAGTACGTGCGATCATTC
CGAAGACACTCTCCCCAGACGATACTCTGA|TGTATCTGAGTCAAGAAACTCCATGTAGGG
AACTCTGATCCCCTTGTAGCACTAGCACAA|ATCATTCGAGTACGTGCGTGCAAGAAACGC
GGAGAAGGCCTGCCTCTAAAACTTAACCTA|TCATTCGAGTACGTGCCACCGTTAAAGATA
GGTCCCTCCAATATGCCGACTTAGGAAGAA|GTTTCGATGATTTAGGCTTGATCATTCGAG
ATTTCCGTGGAGAAGGCCTGCCTCTAAAAC|AGGCTTGATCATTCGAGTACGTGCCACCGT
GTAGGGATGATTTAGGCTTGATCATTCGAG|TGATAAAGTTCAGTACGCTATGGGTTCCTG
TTCGCCTTGGCGTGTAGTCCTCTACGTGTA|CCTACGCGGCGAGAACATGCAGGTTCCTTC
CGAGTACTGATTTAGGCTTGATCATTCGAG|CTCTGTGGGAAGCCACGAAGACACTCTCCC
TAGGCTTGATCATTCGAGTACGTGCGCATG|TATCCTGGCTCGCGTATGTTACGTAGGATT
AGGTTGATTTAGGCTTGATCATTCGAGTAC|GTCAGCGTAACCAGGCCTATGGATGCGCTG
ATTTAGGCTTGATCATTCGAGTACGTGCAG|TAGGCTTGATCATTCGAGTACGTGCGATCA
CCTGATTTAGGCTTTGATTTAGGCTTGATC|GCGAAGATGCGCCCTATAAAACCTAACGGG
TTCAACGTAGCATAGCACATGCAAGTGGTA|AACTGGGGAGTGATTTAGGCTTGATCATTC
TAGGCTGATTTAGGCTTGATCATTCGAGTA|AGCACATGCAAGTGGTATTCTAAGACACTT
GAAGGCCTGCCTCTAAAACTTAACCTATGT|TTCGAGTACGTGCCACCGTTAAAGATAAGT
GTAGGTACATTAATTACATCGAGATCTCAG|TTCGAGTACGTGCCATATAGATTTCCGTGG
GCGTGGTCTAGCGGGTGCCCAACTCTGATC|CGAGTACTGATTTAGGCTTGATCATTCGAG
AGGCTTGATCATTCGAGTACGTGCTCGAGA|TACGCTATGGGTTCCTGATTTAGGCTTTGA
CGCTGTTGCGATGAACCTGGGCAACTGGGG|TAGGCTTGATCATTCGAGTACGTGCTCGAG
TAGTGATTTAGGCTTGATCATTCGAGTACG|CTCAGAGTTATCCTGGCTCGCGTATGTTAC
ACGTGCTTGATCATTCGAGTACTGATTTAG|TTCTGAAGGACACACCTCTGTGGGAAGCCA
GCGTGCAAGAAACGCTTGCTTTCCAAACCG|GATACTCTGATTTCAACGCTGTTGCGATGA
AAAGATAAGTGATTTAGGCTTGATCATTCG|TCTGAAAATCTAGGGTTCCCGCCCGTGATT
ACAATAGGTACAAAGACCTACCGGCTAAGC|GAGGATTTCTAGCTTGTGCTCTGGATACGA
ACCTGGGCAACTGGGGAGTGATTTAGGCTT|CGAGTACGTGCTCGAGATGATTTAGGCTTG
GTTTCGATGATTTAGGCTTGATCATTCGAG|TTTAGGCTTGATCATTCGAGTACGTGCAAC
TGATCATTCGAGTACGTGCGATCATTCGAG|ACGGGTACATTAGCCGAAAACAGCGTACAG
TGATCATTCGAGTACGTGCGTGCAAGAAAC|AGACACTCTCCCCAGACGATACTCTGATTT
TCTGAGTCAAGAAACTCCATGTAGGGATGA|GACCGAAGTTTTACTGGCCATGATAAAGTT
GAATATAGTGTGCGGGGACGTGAGCCCGGA|GAGTACGTGCCCGAGGTTGATTTAGGCTTG
ATTCGAGTACGTGCAGTCAGTTCGCCTTGG|TTCGAGTACGTGCAGCCGAGCCTACGCGGC
TGATCCCCTTGTAGCACTAGCACAATGCGA|TCGAGTACGTGCGTGCAAGAAACGCTTGCT
GATCATTCGAGTACGTGCCATTAACTATCC|TGTATCCAGGTCCCTCCAATATGCCGACTT
GTCAAGAAACTCCATGTAGGGATGATTTAG|AAGTTTTACTGGCCATGATAAAGTTCAGTA
TCATTCGAGTACTGATTTAGGCTTGATCAT|CACACCTCTGTGGGAAGCCACGAAGACACT
TACTGATTTAGGCTTGATCATTCGAGTACG|GTGGGAAGCCACGAAGACACTCTCCCCAGA
CGTGCAGCCGAGCCTACGCGGCGAGAACAT|GCGATCATTCGAGTACGTGCACAATAGGTA
ATGCCGACTTAGGAAGAATATAGTGTGCGG|TAGGCTTGATCATTCGAGTACGTGCCCGAG
AGTCCTCTACGTGTATCTGAGTCAAGAAAC|CATGCAGGTTCCTTCGACCGAAGTTTTACT
GCCTACGCGGCGAGAACATGCAGGTTCCTT|AGTACGTGCACAATAGGTACAAAGACCTAC
AGGTCTGATTTAGGCTTGATCATTCGAGTA|GATTTAGGCTTGATCATTCGAGTACGTGCC
GTCAGTTCGCCTTGGCGTGTAGTCCTCTAC|CCGAGCCTACGCGGCGAGAACATGCAGGTT
GTGCCATATAGATTTCCGTGGAGAAGGCCT|AGCTATGATTTAGGCTTGATCATTCGAGTA
TACGCTATGGGTTCCTGATTTAGGCTTTGA|GTCCTCCGGGTATGCGAAGATGCGCCCTAT
GCACATGCAAGTGGTATTCTAAGACACTTT|TTAGGCTTGATCATTCGAGTACGTGCAGTC
TCGAGTACGTGCAGTCAGTTCGCCTTGGCG|CGAGTACGTGCAGCCGAGCCTACGCGGCGA
TGCGATGAACCTGGGCAACTGGGGAGTGAT|TGATCATTCGAGTACGTGCTCGAGATGATT
ATACTCTGATTTCAACGCTGTTGCGATGAA|CATGTAGGGATGATTTAGGCTTGATCATTC
GCTTGATCATTCGAGTACGTGCGTGCAAGA|CGAAGACACTCTCCCCAGACGATACTCTGA
CGTAGCATAGCACATGCAAGTGGTATTCTA|GGGAGTGATTTAGGCTTGATCATTCGAGTA
GGCTAAGCTGTACCCTCTCCCCCTTGACCT|GGATACGAGCAGCGCACACCCCAACGGTCC
CATTCGAGTACGTGCCATTAACTATCCGCG|ATCCAGGTCCCTCCAATATGCCGACTTAGG
TCTGAAAATCTAGGGTTCCCGCCCGTGATT|TCCAAACCGTCGCAGTCTTCAACGTAGCAT
GATTTAGGCTTGATCATTCGAGTACGTGCC|AACTCTGATCCCCTTGTAGCACTAGCACAA
TACGTGCTTGATCATTCGAGTACTGATTTA|TTTCTGAAGGACACACCTCTGTGGGAAGCC
GATTTAGGCTTGATCATTCGAGTACGTGCC|GTACGTGCGCATGTATCCAGGTCCCTCCAA
CTCCCCAGACGATACTCTGATTTCAACGCT|TCAAGAAACTCCATGTAGGGATGATTTAGG
GATCATTCGAGTACGTGCCACCGTTAAAGA|CCTTGTAGCACTAGCACAATGCGAATCTGA
CCGTTAAAGATAAGTGATTTAGGCTTGATC|GCGAATCTGAAAATCTAGGGTTCCCGCCCG
CTCGAGATGATTTAGGCTTGATCATTCGAG|GCTTTGATTTAGGCTTGATCATTCGAGTAC
ATCTAGGGTTCCCGCCCGTGATTTAGGCTG|CGTCGCAGTCTTCAACGTAGCATAGCACAT
ACCTACCGGCTAAGCTGTACCCTCTCCCCC|GTGCTCTGGATACGAGCAGCGCACACCCCA
TGATTTAGGCTTGATCATTCGAGTACGTGC|CTAGGGTTCCCGCCCGTGATTTAGGCTGAT
CATAGCACATGCAAGTGGTATTCTAAGACA|TGATTTAGGCTTGATCATTCGAGTACGTGC
TGCCTCTAAAACTTAACCTATGTAGGTCTG|ACGTGCCACCGTTAAAGATAAGTGATTTAG
TTCAGTACGCTATGGGTTCCTGATTTAGGC|CTTCCGTCCTCCGGGTATGCGAAGATGCGC
CTTTCCAAACCGTCGCAGTCTTCAACGTAG|CTGTTGCGATGAACCTGGGCAACTGGGGAG
GAGCCTACGCGGCGAGAACATGCAGGTTCC|CGAGTACGTGCACAATAGGTACAAAGACCT
TGGGCAACTGGGGAGTGATTTAGGCTTGAT|GTACGTGCTCGAGATGATTTAGGCTTGATC
AGTTATCCTGGCTCGCGTATGTTACGTAGG|AGAAGGCCTGCCTCTAAAACTTAACCTATG
AGCACATGCAAGTGGTATTCTAAGACACTT|TTTAGGCTTGATCATTCGAGTACGTGCAGT
TGATCATTCGAGTACGTGCCTCTATGACCA|GCCCGTGATTTAGGCTGATTTAGGCTTGAT
TAGGAAGAATATAGTGTGCGGGGACGTGAG|TCATTCGAGTACGTGCCCGAGGTTGATTTA
TCATTCGAGTACGTGCTCGAGATGATTTAG|GGGTTCCTGATTTAGGCTTTGATTTAGGCT
TTTCAACGCTGTTGCGATGAACCTGGGCAA|ATGATTTAGGCTTGATCATTCGAGTACGTG
TGCGCATGTATCCAGGTCCCTCCAATATGC|GTAGGATTGTCTTAGTTTCGATGATTTAGG
TAGGATTGTCTTAGTTTCGATGATTTAGGC|TATGTAGGTCTGATTTAGGCTTGATCATTC
CTACCGGCTAAGCTGTACCCTCTCCCCCTT|GCTCTGGATACGAGCAGCGCACACCCCAAC
GGAGAGGGTAGGTACATTAATTACATCGAG|TTGATCATTCGAGTACGTGCCATATAGATT
GCAGTCAGTTCGCCTTGGCGTGTAGTCCTC|CAGCCGAGCCTACGCGGCGAGAACATGCAG
GTAGCATAGCACATGCAAGTGGTATTCTAA|GGAGTGATTTAGGCTTGATCATTCGAGTAC
TATCCAGGTCCCTCCAATATGCCGACTTAG|GTCTTAGTTTCGATGATTTAGGCTTGATCA
TCGAGTACGTGCCCGAGGTTGATTTAGGCT|GCAACGTAATTCCTAGTCAGCGTAACCAGG
GTGCAACGTAATTCCTAGTCAGCGTAACCA|CTATGACCACTCCTTCGAAGTGGATACTAA
TGTGGGAAGCCACGAAGACACTCTCCCCAG|TAGTCCTCTACGTGTATCTGAGTCAAGAAA
AACTCCATGTAGGGATGATTTAGGCTTGAT|ACTGGCCATGATAAAGTTCAGTACGCTATG
GGCTTGATCATTCGAGTACGTGCAGCCGAG|TTGATCATTCGAGTACGTGCGATCATTCGA
CGAGATGATTTAGGCTTGATCATTCGAGTA|TTTGATTTAGGCTTGATCATTCGAGTACGT
AGTACTGATTTAGGCTTGATCATTCGAGTA|CTGTGGGAAGCCACGAAGACACTCTCCCCA
CATTCGAGTACGTGCAGTCAGTTCGCCTTG|ATTCGAGTACGTGCAGCCGAGCCTACGCGG
CCACGAAGACACTCTCCCCAGACGATACTC|ACGTGTATCTGAGTCAAGAAACTCCATGTA
AGGCCTGCCTCTAAAACTTAACCTATGTAG|CGAGTACGTGCCACCGTTAAAGATAAGTGA
GATCATTCGAGTACGTGCCCGAGGTTGATT|GTACGTGCAACGTAATTCCTAGTCAGCGTA
TCGAGTACGTGCCACCGTTAAAGATAAGTG|AGCACTAGCACAATGCGAATCTGAAAATCT
GTGCCCGAGGTTGATTTAGGCTTGATCATT|ATTCCTAGTCAGCGTAACCAGGCCTATGGA
ATTCGAGTACGTGCCACCGTTAAAGATAAG|GTAGCACTAGCACAATGCGAATCTGAAAAT
CTCTAAAACTTAACCTATGTAGGTCTGATT|TGCCACCGTTAAAGATAAGTGATTTAGGCT
GGCTTGATCATTCGAGTACGTGCTTGATCA|TGGTATTCTAAGACACTTTCTGAAGGACAC
GAGTACGTGCCCGAGGTTGATTTAGGCTTG|AACGTAATTCCTAGTCAGCGTAACCAGGCC
AGTGATTTAGGCTTGATCATTCGAGTACGT|ATGATTTAGGCTTGATCATTCGAGTACGTG
TTTAGGCTTGATCATTCGAGTACGTGCGCA|GTTATCCTGGCTCGCGTATGTTACGTAGGA
CTAGCACAATGCGAATCTGAAAATCTAGGG|AAGAAACGCTTGCTTTCCAAACCGTCGCAG
GTACGTGCCATTAACTATCCGCGTAGAGTT|TCCCTCCAATATGCCGACTTAGGAAGAATA
TAGCATAGCACATGCAAGTGGTATTCTAAG|GAGTGATTTAGGCTTGATCATTCGAGTACG
CCTACCGGCTAAGCTGTACCCTCTCCCCCT|TGCTCTGGATACGAGCAGCGCACACCCCAA
CCTCTATGACCACTCCTTCGAAGTGGATAC|TTTAGGCTTGATCATTCGAGTACGTGCTTG
CACACCTCTGTGGGAAGCCACGAAGACACT|TTGGCGTGTAGTCCTCTACGTGTATCTGAG
CAAACGCCGTTAAGGCATCTAGGCTTTGTT|GCCCGGAGAGGGTAGGTACATTAATTACAT
TCTAGCGGGTGCCCAACTCTGATCCCCTTG|CTGATTTAGGCTTGATCATTCGAGTACGTG
GTTCGCCTTGGCGTGTAGTCCTCTACGTGT|GCCTACGCGGCGAGAACATGCAGGTTCCTT
GCTTGCTTTCCAAACCGTCGCAGTCTTCAA|CAACGCTGTTGCGATGAACCTGGGCAACTG
AAGAATATAGTGTGCGGGGACGTGAGCCCG|TCGAGTACGTGCCCGAGGTTGATTTAGGCT
GCACAATAGGTACAAAGACCTACCGGCTAA|CCGAGGATTTCTAGCTTGTGCTCTGGATAC
CGCCCGTGATTTAGGCTGATTTAGGCTTGA|CAACGTAGCATAGCACATGCAAGTGGTATT
GGGAAGCCACGAAGACACTCTCCCCAGACG|TCCTCTACGTGTATCTGAGTCAAGAAACTC
AGCGGGTGCCCAACTCTGATCCCCTTGTAG|ATTTAGGCTTGATCATTCGAGTACGTGCGT
CAAAGACCTACCGGCTAAGCTGTACCCTCT|AGCTTGTGCTCTGGATACGAGCAGCGCACA
CGAGTACGTGCCTCTATGACCACTCCTTCG|TTTAGGCTGATTTAGGCTTGATCATTCGAG
GCTGATTTAGGCTTGATCATTCGAGTACGT|ACATGCAAGTGGTATTCTAAGACACTTTCT
TCCAGGTCCCTCCAATATGCCGACTTAGGA|CTTAGTTTCGATGATTTAGGCTTGATCATT
GCTTGATCATTCGAGTACTGATTTAGGCTT|GAAGGACACACCTCTGTGGGAAGCCACGAA
CGAGACGGGCCCGCGATTTGATTTAGGCTT|TTTAGGCTTGATCATTCGAGTACGTGCGCA
CTTAGGAAGAATATAGTGTGCGGGGACGTG|GATCATTCGAGTACGTGCCCGAGGTTGATT
CCGATTAATGTCTACTCAAACGCCGTTAAG|GTGTGCGGGGACGTGAGCCCGGAGAGGGTA
GGGATGATTTAGGCTTGATCATTCGAGTAC|TAAAGTTCAGTACGCTATGGGTTCCTGATT
ACACACCTCTGTGGGAAGCCACGAAGACAC|CTTGGCGTGTAGTCCTCTACGTGTATCTGA
TAGGCTTGATCATTCGAGTACGTGCCTCTA|GTTCCCGCCCGTGATTTAGGCTGATTTAGG
GAATCTGAAAATCTAGGGTTCCCGCCCGTG|CTTTCCAAACCGTCGCAGTCTTCAACGTAG
TACGCGGCGAGAACATGCAGGTTCCTTCGA|ACGTGCACAATAGGTACAAAGACCTACCGG
GACTTAGGAAGAATATAGTGTGCGGGGACG|TTGATCATTCGAGTACGTGCCCGAGGTTGA
ATTCTAAGACACTTTCTGAAGGACACACCT|CGAGTACGTGCAGTCAGTTCGCCTTGGCGT
AATGTCTACTCAAACGCCGTTAAGGCATCT|GGGGACGTGAGCCCGGAGAGGGTAGGTACA
CTGAAGGACACACCTCTGTGGGAAGCCACG|AGTTCGCCTTGGCGTGTAGTCCTCTACGTG
CTAGCGGGTGCCCAACTCTGATCCCCTTGT|TGATTTAGGCTTGATCATTCGAGTACGTGC
ACTCCTTCGAAGTGGATACTAATACGCGTG|TCATTCGAGTACGTGCTTGATCATTCGAGT
TCATTCGAGTACGTGCCATATAGATTTCCG|ATGGATGCGCTGAGCTATGATTTAGGCTTG
CTTTCTGAAGGACACACCTCTGTGGGAAGC|AGTCAGTTCGCCTTGGCGTGTAGTCCTCTA
TTGATCATTCGAGTACGTGCCCGAGGTTGA|GAGTACGTGCAACGTAATTCCTAGTCAGCG
ACGCGGCGAGAACATGCAGGTTCCTTCGAC|CGTGCACAATAGGTACAAAGACCTACCGGC
TATCCTGGCTCGCGTATGTTACGTAGGATT|AGGCCTGCCTCTAAAACTTAACCTATGTAG
TGCCATTAACTATCCGCGTAGAGTTCGCCG|CCAATATGCCGACTTAGGAAGAATATAGTG
TTACTGGCCATGATAAAGTTCAGTACGCTA|TACCCTCTCCCCCTTGACCTTCCGTCCTCC
TTGATCATTCGAGTACGTGCCATTAACTAT|CATGTATCCAGGTCCCTCCAATATGCCGAC
GGTTGATTTAGGCTTGATCATTCGAGTACG|TCAGCGTAACCAGGCCTATGGATGCGCTGA
CGTGCGCATGTATCCAGGTCCCTCCAATAT|ACGTAGGATTGTCTTAGTTTCGATGATTTA
TCATTCGAGTACGTGCAGCCGAGCCTACGC|TTCGAGTACGTGCGATCATTCGAGTACGTG
CATTCGAGTACGTGCCTCTATGACCACTCC|GTGATTTAGGCTGATTTAGGCTTGATCATT
AGTACGTGCGCATGTATCCAGGTCCCTCCA|TGTTACGTAGGATTGTCTTAGTTTCGATGA
TGTAGGTCTGATTTAGGCTTGATCATTCGA|AGTGATTTAGGCTTGATCATTCGAGTACGT
AGCTGTACCCTCTCCCCCTTGACCTTCCGT|CGAGCAGCGCACACCCCAACGGTCCCGGTC
TCGACCGAAGTTTTACTGGCCATGATAAAG|CCGGCTAAGCTGTACCCTCTCCCCCTTGAC
GATAAGTGATTTAGGCTTGATCATTCGAGT|GAAAATCTAGGGTTCCCGCCCGTGATTTAG
TTAACCTATGTAGGTCTGATTTAGGCTTGA|TAAAGATAAGTGATTTAGGCTTGATCATTC
CTATGGATGCGCTGAGCTATGATTTAGGCT|GCGTGGTCTAGCGGGTGCCCAACTCTGATC
AAGTGATTTAGGCTTGATCATTCGAGTACG|AATCTAGGGTTCCCGCCCGTGATTTAGGCT
CCTACGCGGCGAGAACATGCAGGTTCCTTC|GTACGTGCACAATAGGTACAAAGACCTACC
TGATTTAGGCTTGATCATTCGAGTACGTGC|TATAAAACCTAACGGGTACATTAGCCGAAA
TGAGCCCGGAGAGGGTAGGTACATTAATTA|TTTAGGCTTGATCATTCGAGTACGTGCCAT
GTACGTGCCCGAGGTTGATTTAGGCTTGAT|CGTAATTCCTAGTCAGCGTAACCAGGCCTA
CTTGCTTTCCAAACCGTCGCAGTCTTCAAC|AACGCTGTTGCGATGAACCTGGGCAACTGG
TTTAGGCTTGATCATTCGAGTACGTGCAAC|CTTGATCATTCGAGTACGTGCCTCTATGAC
GGTGCCCAACTCTGATCCCCTTGTAGCACT|AGGCTTGATCATTCGAGTACGTGCGTGCAA
CGCCGATTAATGTCTACTCAAACGCCGTTA|TAGTGTGCGGGGACGTGAGCCCGGAGAGGG
TCAACGTAGCATAGCACATGCAAGTGGTAT|ACTGGGGAGTGATTTAGGCTTGATCATTCG
TTTAGGCTTGATCATTCGAGTACGTGCCAT|ACGTGCGCATGTATCCAGGTCCCTCCAATA
CGTGATTTAGGCTGATTTAGGCTTGATCAT|GTAGCATAGCACATGCAAGTGGTATTCTAA
CGCTGAGCTATGATTTAGGCTTGATCATTC|AGCGGGTGCCCAACTCTGATCCCCTTGTAG
GTAGTGATTTAGGCTTGATCATTCGAGTAC|TCTCAGAGTTATCCTGGCTCGCGTATGTTA
TCAAGAAACTCCATGTAGGGATGATTTAGG|AGTTTTACTGGCCATGATAAAGTTCAGTAC
TTAGGCTTGATCATTCGAGTACGTGCAACG|TTGATCATTCGAGTACGTGCCTCTATGACC
ATCATTCGAGTACGTGCCACCGTTAAAGAT|CTTGTAGCACTAGCACAATGCGAATCTGAA
TTCGAGTACGTGCAGCCGAGCCTACGCGGC|GAGTACGTGCGATCATTCGAGTACGTGCAC
CCCCAGACGATACTCTGATTTCAACGCTGT|AAGAAACTCCATGTAGGGATGATTTAGGCT
TCATTCGAGTACGTGCGTGCAAGAAACGCT|CACTCTCCCCAGACGATACTCTGATTTCAA
ATTTCAACGCTGTTGCGATGAACCTGGGCA|GATGATTTAGGCTTGATCATTCGAGTACGT
ATCCAGGTCCCTCCAATATGCCGACTTAGG|TCTTAGTTTCGATGATTTAGGCTTGATCAT
TTCAACGCTGTTGCGATGAACCTGGGCAAC|TGATTTAGGCTTGATCATTCGAGTACGTGC
CCTGGCTCGCGTATGTTACGTAGGATTGTC|CCTGCCTCTAAAACTTAACCTATGTAGGTC
AGCTATGATTTAGGCTTGATCATTCGAGTA|GTGCCCAACTCTGATCCCCTTGTAGCACTA
TTAAAGATAAGTGATTTAGGCTTGATCATT|AATCTGAAAATCTAGGGTTCCCGCCCGTGA
ACTATCCGCGTAGAGTTCGCCGATTAATGT|CCGACTTAGGAAGAATATAGTGTGCGGGGA
TTAATGTCTACTCAAACGCCGTTAAGGCAT|GCGGGGACGTGAGCCCGGAGAGGGTAGGTA
TCGAGTACGTGCACAATAGGTACAAAGACC|TACAGGTACACCGAGGATTTCTAGCTTGTG
CCGCGATTTGATTTAGGCTTGATCATTCGA|ATCATTCGAGTACGTGCGCATGTATCCAGG
GTCGCAGTCTTCAACGTAGCATAGCACATG|AACCTGGGCAACTGGGGAGTGATTTAGGCT
AGTTTCGATGATTTAGGCTTGATCATTCGA|ATTTAGGCTTGATCATTCGAGTACGTGCAA
GTGATTTAGGCTGATTTAGGCTTGATCATT|TAGCATAGCACATGCAAGTGGTATTCTAAG
GTGCCACCGTTAAAGATAAGTGATTTAGGC|CACAATGCGAATCTGAAAATCTAGGGTTCC
CGTTAAAGATAAGTGATTTAGGCTTGATCA|CGAATCTGAAAATCTAGGGTTCCCGCCCGT
AGGGTTCCCGCCCGTGATTTAGGCTGATTT|GCAGTCTTCAACGTAGCATAGCACATGCAA
TTAGGCTTGATCATTCGAGTACGTGCAGCC|GGCTTGATCATTCGAGTACGTGCGATCATT
CATTCGAGTACGTGCAGCCGAGCCTACGCG|TCGAGTACGTGCGATCATTCGAGTACGTGC
GTGCCTCTATGACCACTCCTTCGAAGTGGA|TGATTTAGGCTTGATCATTCGAGTACGTGC
AGCATAGCACATGCAAGTGGTATTCTAAGA|AGTGATTTAGGCTTGATCATTCGAGTACGT
CGTAATTCCTAGTCAGCGTAACCAGGCCTA|CCACTCCTTCGAAGTGGATACTAATACGCG
TTAGGAAGAATATAGTGTGCGGGGACGTGA|ATCATTCGAGTACGTGCCCGAGGTTGATTT
CATTCGAGTACGTGCGCATGTATCCAGGTC|CGCGTATGTTACGTAGGATTGTCTTAGTTT
GATCATTCGAGTACGTGCGTGCAAGAAACG|GACACTCTCCCCAGACGATACTCTGATTTC
ACTCTGATCCCCTTGTAGCACTAGCACAAT|TCATTCGAGTACGTGCGTGCAAGAAACGCT
CTAGGGTTCCCGCCCGTGATTTAGGCTGAT|TCGCAGTCTTCAACGTAGCATAGCACATGC
AGTCAGTTCGCCTTGGCGTGTAGTCCTCTA|GCCGAGCCTACGCGGCGAGAACATGCAGGT
GTATCTGAGTCAAGAAACTCCATGTAGGGA|TTCGACCGAAGTTTTACTGGCCATGATAAA
ACGTGCGCATGTATCCAGGTCCCTCCAATA|TACGTAGGATTGTCTTAGTTTCGATGATTT
GGCTTGATCATTCGAGTACGTGCCATTAAC|GCGCATGTATCCAGGTCCCTCCAATATGCC
GGGAGTGATTTAGGCTTGATCATTCGAGTA|GAGATGATTTAGGCTTGATCATTCGAGTAC
ACTCTGATTTCAACGCTGTTGCGATGAACC|TGTAGGGATGATTTAGGCTTGATCATTCGA
TTCGAGTACGTGCACAATAGGTACAAAGAC|GTACAGGTACACCGAGGATTTCTAGCTTGT
TGCCATATAGATTTCCGTGGAGAAGGCCTG|GCTATGATTTAGGCTTGATCATTCGAGTAC
GAGTACGTGCGTGCAAGAAACGCTTGCTTT|CCCCAGACGATACTCTGATTTCAACGCTGT
GAGACGGGCCCGCGATTTGATTTAGGCTTG|TTAGGCTTGATCATTCGAGTACGTGCGCAT
ATTCGAGTACGTGCACAATAGGTACAAAGA|CGTACAGGTACACCGAGGATTTCTAGCTTG
GAGTCAAGAAACTCCATGTAGGGATGATTT|CGAAGTTTTACTGGCCATGATAAAGTTCAG
TCCTTCGACCGAAGTTTTACTGGCCATGAT|CCTACCGGCTAAGCTGTACCCTCTCCCCCT
ACATGCAAGTGGTATTCTAAGACACTTTCT|AGGCTTGATCATTCGAGTACGTGCAGTCAG
AACGTAATTCCTAGTCAGCGTAACCAGGCC|GACCACTCCTTCGAAGTGGATACTAATACG
CTTGATCATTCGAGTACGTGCAACGTAATT|CATTCGAGTACGTGCCTCTATGACCACTCC
TTTCGATGATTTAGGCTTGATCATTCGAGT|TTAGGCTTGATCATTCGAGTACGTGCAACG
TTAGGCTTTGATTTAGGCTTGATCATTCGA|ATGCGCCCTATAAAACCTAACGGGTACATT
ATGGATGCGCTGAGCTATGATTTAGGCTTG|GTGGTCTAGCGGGTGCCCAACTCTGATCCC
CATTCGAGTACGTGCACAATAGGTACAAAG|GCGTACAGGTACACCGAGGATTTCTAGCTT
ACTGGCCATGATAAAGTTCAGTACGCTATG|CCCTCTCCCCCTTGACCTTCCGTCCTCCGG
GCAGGTTCCTTCGACCGAAGTTTTACTGGC|CAAAGACCTACCGGCTAAGCTGTACCCTCT
TCCCCTTGTAGCACTAGCACAATGCGAATC|AGTACGTGCGTGCAAGAAACGCTTGCTTTC
CCCCTTGTAGCACTAGCACAATGCGAATCT|GTACGTGCGTGCAAGAAACGCTTGCTTTCC
ACTCAAACGCCGTTAAGGCATCTAGGCTTT|TGAGCCCGGAGAGGGTAGGTACATTAATTA
CGAATCTGAAAATCTAGGGTTCCCGCCCGT|GCTTTCCAAACCGTCGCAGTCTTCAACGTA
ATTAATGTCTACTCAAACGCCGTTAAGGCA|TGCGGGGACGTGAGCCCGGAGAGGGTAGGT
ATAAGTGATTTAGGCTTGATCATTCGAGTA|AAAATCTAGGGTTCCCGCCCGTGATTTAGG
GCATGTATCCAGGTCCCTCCAATATGCCGA|GGATTGTCTTAGTTTCGATGATTTAGGCTT
TGCCGACTTAGGAAGAATATAGTGTGCGGG|AGGCTTGATCATTCGAGTACGTGCCCGAGG
CACAATAGGTACAAAGACCTACCGGCTAAG|CGAGGATTTCTAGCTTGTGCTCTGGATACG
AACTATCCGCGTAGAGTTCGCCGATTAATG|GCCGACTTAGGAAGAATATAGTGTGCGGGG
TATGCCGACTTAGGAAGAATATAGTGTGCG|TTAGGCTTGATCATTCGAGTACGTGCCCGA
CTCTGATCCCCTTGTAGCACTAGCACAATG|CATTCGAGTACGTGCGTGCAAGAAACGCTT
ATCATTCGAGTACGTGCTCGAGATGATTTA|TGGGTTCCTGATTTAGGCTTTGATTTAGGC
CGAGTACGTGCGTGCAAGAAACGCTTGCTT|TCCCCAGACGATACTCTGATTTCAACGCTG
GTGCGATCATTCGAGTACGTGCACAATAGG|GAAAACAGCGTACAGGTACACCGAGGATTT
GTAGCACTAGCACAATGCGAATCTGAAAAT|GCGTGCAAGAAACGCTTGCTTTCCAAACCG
GTTCCTTCGACCGAAGTTTTACTGGCCATG|GACCTACCGGCTAAGCTGTACCCTCTCCCC
AGCGAGACGGGCCCGCGATTTGATTTAGGC|GATTTAGGCTTGATCATTCGAGTACGTGCG
CGTCGCAGTCTTCAACGTAGCATAGCACAT|GAACCTGGGCAACTGGGGAGTGATTTAGGC
AAGGACACACCTCTGTGGGAAGCCACGAAG|TCGCCTTGGCGTGTAGTCCTCTACGTGTAT
CGTGCAAGAAACGCTTGCTTTCCAAACCGT|ATACTCTGATTTCAACGCTGTTGCGATGAA
AGGGATGATTTAGGCTTGATCATTCGAGTA|ATAAAGTTCAGTACGCTATGGGTTCCTGAT
TTAGGCTTGATCATTCGAGTACGTGCCACC|TCTGATCCCCTTGTAGCACTAGCACAATGC
TCCAAACCGTCGCAGTCTTCAACGTAGCAT|TTGCGATGAACCTGGGCAACTGGGGAGTGA
GACACTCTCCCCAGACGATACTCTGATTTC|TCTGAGTCAAGAAACTCCATGTAGGGATGA
GCTTTCCAAACCGTCGCAGTCTTCAACGTA|GCTGTTGCGATGAACCTGGGCAACTGGGGA
TTTGATTTAGGCTTGATCATTCGAGTACGT|CCTATAAAACCTAACGGGTACATTAGCCGA
GAGTACGTGCCTCTATGACCACTCCTTCGA|TTAGGCTGATTTAGGCTTGATCATTCGAGT
CATCGAGATCTCAGAGTTATCCTGGCTCGC|ATAGATTTCCGTGGAGAAGGCCTGCCTCTA
CCATTAACTATCCGCGTAGAGTTCGCCGAT|AATATGCCGACTTAGGAAGAATATAGTGTG
GCAAGAAACGCTTGCTTTCCAAACCGTCGC|CTCTGATTTCAACGCTGTTGCGATGAACCT
TAGGCTTGATCATTCGAGTACGTGCCATTA|GTGCGCATGTATCCAGGTCCCTCCAATATG
ATATAGATTTCCGTGGAGAAGGCCTGCCTC|TGATTTAGGCTTGATCATTCGAGTACGTGC
TTGATCATTCGAGTACGTGCCACCGTTAAA|CCCCTTGTAGCACTAGCACAATGCGAATCT
CGCAGTCTTCAACGTAGCATAGCACATGCA|CCTGGGCAACTGGGGAGTGATTTAGGCTTG
ACCAGGCCTATGGATGCGCTGAGCTATGAT|CTAATACGCGTGGTCTAGCGGGTGCCCAAC
GCCATATAGATTTCCGTGGAGAAGGCCTGC|CTATGATTTAGGCTTGATCATTCGAGTACG
GCGAGAACATGCAGGTTCCTTCGACCGAAG|ACAATAGGTACAAAGACCTACCGGCTAAGC
AAACTTAACCTATGTAGGTCTGATTTAGGC|CCGTTAAAGATAAGTGATTTAGGCTTGATC
GAGCCCGGAGAGGGTAGGTACATTAATTAC|TTAGGCTTGATCATTCGAGTACGTGCCATA
TGATTTAGGCTTGATCATTCGAGTACGTGC|CAACTCTGATCCCCTTGTAGCACTAGCACA
ACGTGCCCGAGGTTGATTTAGGCTTGATCA|TAATTCCTAGTCAGCGTAACCAGGCCTATG
TCGCCTTGGCGTGTAGTCCTCTACGTGTAT|CTACGCGGCGAGAACATGCAGGTTCCTTCG
AAGTGGTATTCTAAGACACTTTCTGAAGGA|GATCATTCGAGTACGTGCAGTCAGTTCGCC
CGTGTAGTCCTCTACGTGTATCTGAGTCAA|GAGAACATGCAGGTTCCTTCGACCGAAGTT
ACATCGAGATCTCAGAGTTATCCTGGCTCG|TATAGATTTCCGTGGAGAAGGCCTGCCTCT
AGTACGTGCAGTCAGTTCGCCTTGGCGTGT|GTACGTGCAGCCGAGCCTACGCGGCGAGAA
GAGTACGTGCAACGTAATTCCTAGTCAGCG|GTGCCTCTATGACCACTCCTTCGAAGTGGA
AAGACACTTTCTGAAGGACACACCTCTGTG|ACGTGCAGTCAGTTCGCCTTGGCGTGTAGT
TATGGGTTCCTGATTTAGGCTTTGATTTAG|CCGGGTATGCGAAGATGCGCCCTATAAAAC
ACATTAATTACATCGAGATCTCAGAGTTAT|TACGTGCCATATAGATTTCCGTGGAGAAGG
TACGTGCAGTCAGTTCGCCTTGGCGTGTAG|ACGTGCAGCCGAGCCTACGCGGCGAGAACA
GAGTACGTGCGATCATTCGAGTACGTGCAC|TTAGCCGAAAACAGCGTACAGGTACACCGA
TCAAACGCCGTTAAGGCATCTAGGCTTTGT|AGCCCGGAGAGGGTAGGTACATTAATTACA
TTATCCTGGCTCGCGTATGTTACGTAGGAT|AAGGCCTGCCTCTAAAACTTAACCTATGTA
CTTGATCATTCGAGTACGTGCGATCATTCG|TAACGGGTACATTAGCCGAAAACAGCGTAC
ACGTGCACAATAGGTACAAAGACCTACCGG|TACACCGAGGATTTCTAGCTTGTGCTCTGG
ACAATGCGAATCTGAAAATCTAGGGTTCCC|ACGCTTGCTTTCCAAACCGTCGCAGTCTTC
TACGTGCCTCTATGACCACTCCTTCGAAGT|GGCTGATTTAGGCTTGATCATTCGAGTACG
CCAACTCTGATCCCCTTGTAGCACTAGCAC|TGATCATTCGAGTACGTGCGTGCAAGAAAC
AGCCGAGCCTACGCGGCGAGAACATGCAGG|CATTCGAGTACGTGCACAATAGGTACAAAG
CTTGATCATTCGAGTACGTGCGTGCAAGAA|GAAGACACTCTCCCCAGACGATACTCTGAT
GGCTTGATCATTCGAGTACGTGCGATCATT|CCTAACGGGTACATTAGCCGAAAACAGCGT
AAAGTTCAGTACGCTATGGGTTCCTGATTT|TGACCTTCCGTCCTCCGGGTATGCGAAGAT
CTGGCCATGATAAAGTTCAGTACGCTATGG|CCTCTCCCCCTTGACCTTCCGTCCTCCGGG
CCCGAGGTTGATTTAGGCTTGATCATTCGA|CCTAGTCAGCGTAACCAGGCCTATGGATGC
TGCAGTCAGTTCGCCTTGGCGTGTAGTCCT|GCAGCCGAGCCTACGCGGCGAGAACATGCA
GATTTAGGCTTGATCATTCGAGTACGTGCC|CGTAACCAGGCCTATGGATGCGCTGAGCTA
GGCCCGCGATTTGATTTAGGCTTGATCATT|TTGATCATTCGAGTACGTGCGCATGTATCC
GATTTAGGCTTGATCATTCGAGTACGTGCC|TAGGGTTCCCGCCCGTGATTTAGGCTGATT
GATCATTCGAGTACTGATTTAGGCTTGATC|GACACACCTCTGTGGGAAGCCACGAAGACA
ACTAGCACAATGCGAATCTGAAAATCTAGG|CAAGAAACGCTTGCTTTCCAAACCGTCGCA
AGACGATACTCTGATTTCAACGCTGTTGCG|AACTCCATGTAGGGATGATTTAGGCTTGAT
TTGATCATTCGAGTACGTGCTCGAGATGAT|CTATGGGTTCCTGATTTAGGCTTTGATTTA
ATATGCCGACTTAGGAAGAATATAGTGTGC|TTTAGGCTTGATCATTCGAGTACGTGCCCG
TAGGCTTGATCATTCGAGTACGTGCGATCA|AACCTAACGGGTACATTAGCCGAAAACAGC
GTCCCTCCAATATGCCGACTTAGGAAGAAT|TTTCGATGATTTAGGCTTGATCATTCGAGT
TAGCGGGTGCCCAACTCTGATCCCCTTGTA|GATTTAGGCTTGATCATTCGAGTACGTGCG
AGTGATTTAGGCTTGATCATTCGAGTACGT|TCAGAGTTATCCTGGCTCGCGTATGTTACG
CTTGATCATTCGAGTACGTGCAGCCGAGCC|GATCATTCGAGTACGTGCGATCATTCGAGT
GCGGGGACGTGAGCCCGGAGAGGGTAGGTA|CGAGGTTGATTTAGGCTTGATCATTCGAGT
TAAAACTTAACCTATGTAGGTCTGATTTAG|CACCGTTAAAGATAAGTGATTTAGGCTTGA
TCCTGATTTAGGCTTTGATTTAGGCTTGAT|TGCGAAGATGCGCCCTATAAAACCTAACGG
TGATTTAGGCTTGATCATTCGAGTACGTGC|AGAGTTATCCTGGCTCGCGTATGTTACGTA
ATTCGAGTACGTGCCATTAACTATCCGCGT|TCCAGGTCCCTCCAATATGCCGACTTAGGA
ATGATTTAGGCTTGATCATTCGAGTACGTG|AGTTCAGTACGCTATGGGTTCCTGATTTAG
GGCTCGCGTATGTTACGTAGGATTGTCTTA|GCCTCTAAAACTTAACCTATGTAGGTCTGA
TCGAGTACGTGCCATATAGATTTCCGTGGA|ATGCGCTGAGCTATGATTTAGGCTTGATCA
TGATCATTCGAGTACGTGCTCGAGATGATT|TATGGGTTCCTGATTTAGGCTTTGATTTAG
TAATTCCTAGTCAGCGTAACCAGGCCTATG|ACTCCTTCGAAGTGGATACTAATACGCGTG
GTGCTCGAGATGATTTAGGCTTGATCATTC|TAGGCTTTGATTTAGGCTTGATCATTCGAG
AGTTCAGTACGCTATGGGTTCCTGATTTAG|ACCTTCCGTCCTCCGGGTATGCGAAGATGC
GTCTGATTTAGGCTTGATCATTCGAGTACG|TTTAGGCTTGATCATTCGAGTACGTGCCTC
AGGCATCTAGGCTTTGTTATTTCGTAGTGA|TAGGTACATTAATTACATCGAGATCTCAGA
GAAACGCTTGCTTTCCAAACCGTCGCAGTC|GATTTCAACGCTGTTGCGATGAACCTGGGC
AAACGCTTGCTTTCCAAACCGTCGCAGTCT|ATTTCAACGCTGTTGCGATGAACCTGGGCA
CTTCGAAGTGGATACTAATACGCGTGGTCT|TCGAGTACGTGCTTGATCATTCGAGTACTG
AACCTATGTAGGTCTGATTTAGGCTTGATC|AAGATAAGTGATTTAGGCTTGATCATTCGA
GTGGGAAGCCACGAAGACACTCTCCCCAGA|AGTCCTCTACGTGTATCTGAGTCAAGAAAC
AGTACGTGCCATTAACTATCCGCGTAGAGT|GTCCCTCCAATATGCCGACTTAGGAAGAAT
CCTTGTAGCACTAGCACAATGCGAATCTGA|ACGTGCGTGCAAGAAACGCTTGCTTTCCAA
TTCGAGTACGTGCGATCATTCGAGTACGTG|ACATTAGCCGAAAACAGCGTACAGGTACAC
CTTAGTTTCGATGATTTAGGCTTGATCATT|CTGATTTAGGCTTGATCATTCGAGTACGTG
CTGTTGCGATGAACCTGGGCAACTGGGGAG|GGCTTGATCATTCGAGTACGTGCTCGAGAT
AGGACACACCTCTGTGGGAAGCCACGAAGA|CGCCTTGGCGTGTAGTCCTCTACGTGTATC
AAACCGTCGCAGTCTTCAACGTAGCATAGC|CGATGAACCTGGGCAACTGGGGAGTGATTT
TATAGATTTCCGTGGAGAAGGCCTGCCTCT|GATTTAGGCTTGATCATTCGAGTACGTGCC
ATTTAGGCTTGATCATTCGAGTACGTGCGA|TAAAACCTAACGGGTACATTAGCCGAAAAC
GGGACGTGAGCCCGGAGAGGGTAGGTACAT|GGTTGATTTAGGCTTGATCATTCGAGTACG
ATAGCACATGCAAGTGGTATTCTAAGACAC|GATTTAGGCTTGATCATTCGAGTACGTGCA
GGCTTGATCATTCGAGTACGTGCTCGAGAT|ACGCTATGGGTTCCTGATTTAGGCTTTGAT
TGGATACTAATACGCGTGGTCTAGCGGGTG|GTGCTTGATCATTCGAGTACTGATTTAGGC
GGTACATTAATTACATCGAGATCTCAGAGT|GAGTACGTGCCATATAGATTTCCGTGGAGA
TACATCGAGATCTCAGAGTTATCCTGGCTC|ATATAGATTTCCGTGGAGAAGGCCTGCCTC
TGATCATTCGAGTACGTGCAACGTAATTCC|TTCGAGTACGTGCCTCTATGACCACTCCTT
CAGCCGAGCCTACGCGGCGAGAACATGCAG|TCATTCGAGTACGTGCACAATAGGTACAAA
GATCATTCGAGTACGTGCAACGTAATTCCT|TCGAGTACGTGCCTCTATGACCACTCCTTC
CCGCCCGTGATTTAGGCTGATTTAGGCTTG|TCAACGTAGCATAGCACATGCAAGTGGTAT
ATCATTCGAGTACGTGCCTCTATGACCACT|CCGTGATTTAGGCTGATTTAGGCTTGATCA
TAGGTACAAAGACCTACCGGCTAAGCTGTA|ATTTCTAGCTTGTGCTCTGGATACGAGCAG
GCAAGTGGTATTCTAAGACACTTTCTGAAG|TTGATCATTCGAGTACGTGCAGTCAGTTCG
GACGATACTCTGATTTCAACGCTGTTGCGA|ACTCCATGTAGGGATGATTTAGGCTTGATC
TTAGGCTTGATCATTCGAGTACGTGCCTCT|GGTTCCCGCCCGTGATTTAGGCTGATTTAG
AGCCTACGCGGCGAGAACATGCAGGTTCCT|GAGTACGTGCACAATAGGTACAAAGACCTA
TAATTACATCGAGATCTCAGAGTTATCCTG|TGCCATATAGATTTCCGTGGAGAAGGCCTG
TCAACGCTGTTGCGATGAACCTGGGCAACT|GATTTAGGCTTGATCATTCGAGTACGTGCT
GCCCGTGATTTAGGCTGATTTAGGCTTGAT|AACGTAGCATAGCACATGCAAGTGGTATTC
TCTAGGGTTCCCGCCCGTGATTTAGGCTGA|GTCGCAGTCTTCAACGTAGCATAGCACATG
GGCGTGTAGTCCTCTACGTGTATCTGAGTC|GCGAGAACATGCAGGTTCCTTCGACCGAAG
GTAATTCCTAGTCAGCGTAACCAGGCCTAT|CACTCCTTCGAAGTGGATACTAATACGCGT
TTGATCATTCGAGTACGTGCCTCTATGACC|CGCCCGTGATTTAGGCTGATTTAGGCTTGA
GCACTAGCACAATGCGAATCTGAAAATCTA|TGCAAGAAACGCTTGCTTTCCAAACCGTCG
GTAACCAGGCCTATGGATGCGCTGAGCTAT|ATACTAATACGCGTGGTCTAGCGGGTGCCC
TAGTCCTCTACGTGTATCTGAGTCAAGAAA|ACATGCAGGTTCCTTCGACCGAAGTTTTAC
CGAAGTTTTACTGGCCATGATAAAGTTCAG|TAAGCTGTACCCTCTCCCCCTTGACCTTCC
AGTTTTACTGGCCATGATAAAGTTCAGTAC|GCTGTACCCTCTCCCCCTTGACCTTCCGTC
GATTTAGGCTTGATCATTCGAGTACGTGCT|TGCAAGTGGTATTCTAAGACACTTTCTGAA
TGTATCCAGGTCCCTCCAATATGCCGACTT|TTGTCTTAGTTTCGATGATTTAGGCTTGAT
GGGTGCCCAACTCTGATCCCCTTGTAGCAC|TAGGCTTGATCATTCGAGTACGTGCGTGCA
TGCGGGGACGTGAGCCCGGAGAGGGTAGGT|CCGAGGTTGATTTAGGCTTGATCATTCGAG
CTGATTTAGGCTTGATCATTCGAGTACGTG|CATGCAAGTGGTATTCTAAGACACTTTCTG
TTGATCATTCGAGTACGTGCAGCCGAGCCT|ATCATTCGAGTACGTGCGATCATTCGAGTA
TTCGAGTACGTGCCACCGTTAAAGATAAGT|TAGCACTAGCACAATGCGAATCTGAAAATC
GATCATTCGAGTACGTGCTCGAGATGATTT|ATGGGTTCCTGATTTAGGCTTTGATTTAGG
GATTTAGGCTTTGATTTAGGCTTGATCATT|AAGATGCGCCCTATAAAACCTAACGGGTAC
TTAGGCTTGATCATTCGAGTACGTGCAGTC|TAGGCTTGATCATTCGAGTACGTGCAGCCG
GCCCAACTCTGATCCCCTTGTAGCACTAGC|CTTGATCATTCGAGTACGTGCGTGCAAGAA
GTTATTTCGTAGTGATTTAGGCTTGATCAT|CATCGAGATCTCAGAGTTATCCTGGCTCGC
TCGCAGTCTTCAACGTAGCATAGCACATGC|ACCTGGGCAACTGGGGAGTGATTTAGGCTT
ATCATTCGAGTACGTGCGATCATTCGAGTA|GGGTACATTAGCCGAAAACAGCGTACAGGT
GGCTTTGATTTAGGCTTGATCATTCGAGTA|CGCCCTATAAAACCTAACGGGTACATTAGC
AATATAGTGTGCGGGGACGTGAGCCCGGAG|AGTACGTGCCCGAGGTTGATTTAGGCTTGA
ACACTTTCTGAAGGACACACCTCTGTGGGA|TGCAGTCAGTTCGCCTTGGCGTGTAGTCCT
AGGCTTGATCATTCGAGTACGTGCCCGAGG|ATTCGAGTACGTGCAACGTAATTCCTAGTC
AATATGCCGACTTAGGAAGAATATAGTGTG|ATTTAGGCTTGATCATTCGAGTACGTGCCC
AAACTCCATGTAGGGATGATTTAGGCTTGA|TACTGGCCATGATAAAGTTCAGTACGCTAT
TTCGAGTACGTGCAACGTAATTCCTAGTCA|TACGTGCCTCTATGACCACTCCTTCGAAGT
TCTGAAGGACACACCTCTGTGGGAAGCCAC|CAGTTCGCCTTGGCGTGTAGTCCTCTACGT
TCTCAGAGTTATCCTGGCTCGCGTATGTTA|CCGTGGAGAAGGCCTGCCTCTAAAACTTAA
TGATCATTCGAGTACGTGCGCATGTATCCA|GGCTCGCGTATGTTACGTAGGATTGTCTTA
ATTCGAGTACGTGCGATCATTCGAGTACGT|TACATTAGCCGAAAACAGCGTACAGGTACA
GAGTACGTGCCACCGTTAAAGATAAGTGAT|CACTAGCACAATGCGAATCTGAAAATCTAG
ATCATTCGAGTACGTGCGTGCAAGAAACGC|ACACTCTCCCCAGACGATACTCTGATTTCA
GCTTGATCATTCGAGTACGTGCCTCTATGA|CCCGCCCGTGATTTAGGCTGATTTAGGCTT
ACGTGCTCGAGATGATTTAGGCTTGATCAT|TTTAGGCTTTGATTTAGGCTTGATCATTCG
GTGATTTAGGCTTGATCATTCGAGTACGTG|TCTAGGGTTCCCGCCCGTGATTTAGGCTGA
TTAGGCTTGATCATTCGAGTACGTGCTCGA|AGTACGCTATGGGTTCCTGATTTAGGCTTT
CTTGATCATTCGAGTACTGATTTAGGCTTG|AAGGACACACCTCTGTGGGAAGCCACGAAG
TTAACTATCCGCGTAGAGTTCGCCGATTAA|ATGCCGACTTAGGAAGAATATAGTGTGCGG
AGGCTTTGTTATTTCGTAGTGATTTAGGCT|TTAATTACATCGAGATCTCAGAGTTATCCT
TCGCCGATTAATGTCTACTCAAACGCCGTT|ATAGTGTGCGGGGACGTGAGCCCGGAGAGG
AGGCTGATTTAGGCTTGATCATTCGAGTAC|GCACATGCAAGTGGTATTCTAAGACACTTT
TATGGATGCGCTGAGCTATGATTTAGGCTT|CGTGGTCTAGCGGGTGCCCAACTCTGATCC
ACTTTCTGAAGGACACACCTCTGTGGGAAG|CAGTCAGTTCGCCTTGGCGTGTAGTCCTCT
TCGAGTACGTGCCTCTATGACCACTCCTTC|ATTTAGGCTGATTTAGGCTTGATCATTCGA
AAGAAACTCCATGTAGGGATGATTTAGGCT|TTTTACTGGCCATGATAAAGTTCAGTACGC
GCCATTAACTATCCGCGTAGAGTTCGCCGA|CAATATGCCGACTTAGGAAGAATATAGTGT
GTGGATACTAATACGCGTGGTCTAGCGGGT|CGTGCTTGATCATTCGAGTACTGATTTAGG
AAGTTCAGTACGCTATGGGTTCCTGATTTA|GACCTTCCGTCCTCCGGGTATGCGAAGATG
GGCTGATTTAGGCTTGATCATTCGAGTACG|CACATGCAAGTGGTATTCTAAGACACTTTC
TTAGTTTCGATGATTTAGGCTTGATCATTC|TGATTTAGGCTTGATCATTCGAGTACGTGC
TTTAGGCTTGATCATTCGAGTACGTGCCCG|ATCATTCGAGTACGTGCAACGTAATTCCTA
TAATACGCGTGGTCTAGCGGGTGCCCAACT|ATCATTCGAGTACTGATTTAGGCTTGATCA
ACGTGCCACCGTTAAAGATAAGTGATTTAG|AGCACAATGCGAATCTGAAAATCTAGGGTT
ATGATTTAGGCTTGATCATTCGAGTACGTG|ATTTAGGCTTGATCATTCGAGTACGTGCGA
AGGCTTGATCATTCGAGTACGTGCCACCGT|TGATCCCCTTGTAGCACTAGCACAATGCGA
ATTCGAGTACGTGCCATATAGATTTCCGTG|GGATGCGCTGAGCTATGATTTAGGCTTGAT
CGAGTACGTGCAACGTAATTCCTAGTCAGC|CGTGCCTCTATGACCACTCCTTCGAAGTGG
TTGATCATTCGAGTACGTGCGCATGTATCC|TGGCTCGCGTATGTTACGTAGGATTGTCTT
TGCGAATCTGAAAATCTAGGGTTCCCGCCC|TTGCTTTCCAAACCGTCGCAGTCTTCAACG
AGTACGTGCTCGAGATGATTTAGGCTTGAT|TGATTTAGGCTTTGATTTAGGCTTGATCAT
GTGCTTGATCATTCGAGTACTGATTTAGGC|CTGAAGGACACACCTCTGTGGGAAGCCACG
TACGTGCGTGCAAGAAACGCTTGCTTTCCA|CAGACGATACTCTGATTTCAACGCTGTTGC
AGTACGTGCCTCTATGACCACTCCTTCGAA|TAGGCTGATTTAGGCTTGATCATTCGAGTA
CGTGCCATTAACTATCCGCGTAGAGTTCGC|CTCCAATATGCCGACTTAGGAAGAATATAG
ACTAATACGCGTGGTCTAGCGGGTGCCCAA|TGATCATTCGAGTACTGATTTAGGCTTGAT
TACGTGCCATATAGATTTCCGTGGAGAAGG|CTGAGCTATGATTTAGGCTTGATCATTCGA
CGATTTGATTTAGGCTTGATCATTCGAGTA|ATTCGAGTACGTGCGCATGTATCCAGGTCC
ATCCTGGCTCGCGTATGTTACGTAGGATTG|GGCCTGCCTCTAAAACTTAACCTATGTAGG
CCGCGTAGAGTTCGCCGATTAATGTCTACT|TTAGGAAGAATATAGTGTGCGGGGACGTGA
ATTGTCTTAGTTTCGATGATTTAGGCTTGA|TAGGTCTGATTTAGGCTTGATCATTCGAGT
ACGCGTGGTCTAGCGGGTGCCCAACTCTGA|TTCGAGTACTGATTTAGGCTTGATCATTCG
CGTGCACAATAGGTACAAAGACCTACCGGC|ACACCGAGGATTTCTAGCTTGTGCTCTGGA
CGTGGTCTAGCGGGTGCCCAACTCTGATCC|GAGTACTGATTTAGGCTTGATCATTCGAGT
GCCCGGAGAGGGTAGGTACATTAATTACAT|AGGCTTGATCATTCGAGTACGTGCCATATA
TTAGGCTTGATCATTCGAGTACGTGCCATT|CGTGCGCATGTATCCAGGTCCCTCCAATAT
CGTGAGCCCGGAGAGGGTAGGTACATTAAT|GATTTAGGCTTGATCATTCGAGTACGTGCC
GCTGTTGCGATGAACCTGGGCAACTGGGGA|AGGCTTGATCATTCGAGTACGTGCTCGAGA
TGATCATTCGAGTACGTGCAGCCGAGCCTA|TCATTCGAGTACGTGCGATCATTCGAGTAC
CGAGTACGTGCGCATGTATCCAGGTCCCTC|TATGTTACGTAGGATTGTCTTAGTTTCGAT
CAACGCTGTTGCGATGAACCTGGGCAACTG|ATTTAGGCTTGATCATTCGAGTACGTGCTC
AGTTCGCCGATTAATGTCTACTCAAACGCC|AATATAGTGTGCGGGGACGTGAGCCCGGAG
AGAGTTCGCCGATTAATGTCTACTCAAACG|AGAATATAGTGTGCGGGGACGTGAGCCCGG
CTTGGCGTGTAGTCCTCTACGTGTATCTGA|GCGGCGAGAACATGCAGGTTCCTTCGACCG
CAACGTAGCATAGCACATGCAAGTGGTATT|CTGGGGAGTGATTTAGGCTTGATCATTCGA
AAGTTTTACTGGCCATGATAAAGTTCAGTA|AGCTGTACCCTCTCCCCCTTGACCTTCCGT
GTGAGCCCGGAGAGGGTAGGTACATTAATT|ATTTAGGCTTGATCATTCGAGTACGTGCCA
AGGCTTGATCATTCGAGTACGTGCCTCTAT|TTCCCGCCCGTGATTTAGGCTGATTTAGGC
GGATTGTCTTAGTTTCGATGATTTAGGCTT|TGTAGGTCTGATTTAGGCTTGATCATTCGA
TAGGCTTGATCATTCGAGTACGTGCAACGT|TGATCATTCGAGTACGTGCCTCTATGACCA
GAGTACGTGCCATATAGATTTCCGTGGAGA|GCGCTGAGCTATGATTTAGGCTTGATCATT
AAGGCATCTAGGCTTTGTTATTTCGTAGTG|GTAGGTACATTAATTACATCGAGATCTCAG
TTTAGGCTTGATCATTCGAGTACGTGCAGC|AGGCTTGATCATTCGAGTACGTGCGATCAT
TAGTGTGCGGGGACGTGAGCCCGGAGAGGG|CGTGCCCGAGGTTGATTTAGGCTTGATCAT
GAGGGTAGGTACATTAATTACATCGAGATC|ATCATTCGAGTACGTGCCATATAGATTTCC
TATGATTTAGGCTTGATCATTCGAGTACGT|CCCAACTCTGATCCCCTTGTAGCACTAGCA
TCTTAGTTTCGATGATTTAGGCTTGATCAT|TCTGATTTAGGCTTGATCATTCGAGTACGT
AGTACGTGCCATATAGATTTCCGTGGAGAA|CGCTGAGCTATGATTTAGGCTTGATCATTC
TTAGGCTTGATCATTCGAGTACGTGCCATA|AACCAGGCCTATGGATGCGCTGAGCTATGA
GTACGTGCTCGAGATGATTTAGGCTTGATC|GATTTAGGCTTTGATTTAGGCTTGATCATT
GATTTAGGCTGATTTAGGCTTGATCATTCG|GCATAGCACATGCAAGTGGTATTCTAAGAC
AGATCTCAGAGTTATCCTGGCTCGCGTATG|TTTCCGTGGAGAAGGCCTGCCTCTAAAACT
TCCTTCGAAGTGGATACTAATACGCGTGGT|ATTCGAGTACGTGCTTGATCATTCGAGTAC
AACCAGGCCTATGGATGCGCTGAGCTATGA|ACTAATACGCGTGGTCTAGCGGGTGCCCAA
GGGCCCGCGATTTGATTTAGGCTTGATCAT|CTTGATCATTCGAGTACGTGCGCATGTATC
GCGATCATTCGAGTACGTGCACAATAGGTA|AAACAGCGTACAGGTACACCGAGGATTTCT
GGCTTGATCATTCGAGTACGTGCGCATGTA|TCCTGGCTCGCGTATGTTACGTAGGATTGT
ACGCTTGCTTTCCAAACCGTCGCAGTCTTC|TTCAACGCTGTTGCGATGAACCTGGGCAAC
GGGGAGTGATTTAGGCTTGATCATTCGAGT|CGAGATGATTTAGGCTTGATCATTCGAGTA
TGTTGCGATGAACCTGGGCAACTGGGGAGT|GCTTGATCATTCGAGTACGTGCTCGAGATG
GTAGAGTTCGCCGATTAATGTCTACTCAAA|GAAGAATATAGTGTGCGGGGACGTGAGCCC
CTGATTTAGGCTTGATCATTCGAGTACGTG|GGGAAGCCACGAAGACACTCTCCCCAGACG
TGTTATTTCGTAGTGATTTAGGCTTGATCA|ACATCGAGATCTCAGAGTTATCCTGGCTCG
GTAGTCCTCTACGTGTATCTGAGTCAAGAA|AACATGCAGGTTCCTTCGACCGAAGTTTTA
CATTCGAGTACGTGCGTGCAAGAAACGCTT|ACTCTCCCCAGACGATACTCTGATTTCAAC
GGTTCCCGCCCGTGATTTAGGCTGATTTAG|AGTCTTCAACGTAGCATAGCACATGCAAGT
AGGTTCCTTCGACCGAAGTTTTACTGGCCA|AAGACCTACCGGCTAAGCTGTACCCTCTCC
TGCCCAACTCTGATCCCCTTGTAGCACTAG|GCTTGATCATTCGAGTACGTGCGTGCAAGA
CTTGATCATTCGAGTACGTGCTTGATCATT|GTATTCTAAGACACTTTCTGAAGGACACAC
GCTATGATTTAGGCTTGATCATTCGAGTAC|TGCCCAACTCTGATCCCCTTGTAGCACTAG
GATCATTCGAGTACGTGCCTCTATGACCAC|CCCGTGATTTAGGCTGATTTAGGCTTGATC
GCGGCGAGAACATGCAGGTTCCTTCGACCG|TGCACAATAGGTACAAAGACCTACCGGCTA
TTTAGGCTTGATCATTCGAGTACGTGCGTG|AGCCACGAAGACACTCTCCCCAGACGATAC
TCTGATTTAGGCTTGATCATTCGAGTACGT|TTAGGCTTGATCATTCGAGTACGTGCCTCT
GACACTTTCTGAAGGACACACCTCTGTGGG|GTGCAGTCAGTTCGCCTTGGCGTGTAGTCC
GAGCTATGATTTAGGCTTGATCATTCGAGT|GGTGCCCAACTCTGATCCCCTTGTAGCACT
TGATTTAGGCTGATTTAGGCTTGATCATTC|AGCATAGCACATGCAAGTGGTATTCTAAGA
CCTATGGATGCGCTGAGCTATGATTTAGGC|CGCGTGGTCTAGCGGGTGCCCAACTCTGAT
CGTGGAGAAGGCCTGCCTCTAAAACTTAAC|TGATCATTCGAGTACGTGCCACCGTTAAAG
CTCTGTGGGAAGCCACGAAGACACTCTCCC|GTGTAGTCCTCTACGTGTATCTGAGTCAAG
GGATGCGCTGAGCTATGATTTAGGCTTGAT|GGTCTAGCGGGTGCCCAACTCTGATCCCCT
TCTGTGGGAAGCCACGAAGACACTCTCCCC|TGTAGTCCTCTACGTGTATCTGAGTCAAGA
GAGATCTCAGAGTTATCCTGGCTCGCGTAT|ATTTCCGTGGAGAAGGCCTGCCTCTAAAAC
CATGCAGGTTCCTTCGACCGAAGTTTTACT|GTACAAAGACCTACCGGCTAAGCTGTACCC
ATCATTCGAGTACGTGCACAATAGGTACAA|CAGCGTACAGGTACACCGAGGATTTCTAGC
TTCCAAACCGTCGCAGTCTTCAACGTAGCA|GTTGCGATGAACCTGGGCAACTGGGGAGTG
TTCGAGTACGTGCTTGATCATTCGAGTACT|AGACACTTTCTGAAGGACACACCTCTGTGG
CGCGTATGTTACGTAGGATTGTCTTAGTTT|CTAAAACTTAACCTATGTAGGTCTGATTTA
ACCTCTGTGGGAAGCCACGAAGACACTCTC|GCGTGTAGTCCTCTACGTGTATCTGAGTCA
AAATCTAGGGTTCCCGCCCGTGATTTAGGC|ACCGTCGCAGTCTTCAACGTAGCATAGCAC
GGCTTGATCATTCGAGTACGTGCCTCTATG|TCCCGCCCGTGATTTAGGCTGATTTAGGCT
GCCATGATAAAGTTCAGTACGCTATGGGTT|CTCCCCCTTGACCTTCCGTCCTCCGGGTAT
AATAGGTACAAAGACCTACCGGCTAAGCTG|GGATTTCTAGCTTGTGCTCTGGATACGAGC
GCCTGCCTCTAAAACTTAACCTATGTAGGT|AGTACGTGCCACCGTTAAAGATAAGTGATT
GTATTCTAAGACACTTTCTGAAGGACACAC|TTCGAGTACGTGCAGTCAGTTCGCCTTGGC
GATCATTCGAGTACGTGCAGCCGAGCCTAC|CATTCGAGTACGTGCGATCATTCGAGTACG
TCGATGATTTAGGCTTGATCATTCGAGTAC|AGGCTTGATCATTCGAGTACGTGCAACGTA
ATCCCCTTGTAGCACTAGCACAATGCGAAT|GAGTACGTGCGTGCAAGAAACGCTTGCTTT
AGATAAGTGATTTAGGCTTGATCATTCGAG|TGAAAATCTAGGGTTCCCGCCCGTGATTTA
TCGAGTACGTGCGTGCAAGAAACGCTTGCT|CTCCCCAGACGATACTCTGATTTCAACGCT
TCCTAGTCAGCGTAACCAGGCCTATGGATG|CTTCGAAGTGGATACTAATACGCGTGGTCT
TGATTTAGGCTTGATCATTCGAGTACGTGC|AGTACGTGCGCATGTATCCAGGTCCCTCCA
GAAGACACTCTCCCCAGACGATACTCTGAT|GTATCTGAGTCAAGAAACTCCATGTAGGGA
GATTTAGGCTTGATCATTCGAGTACGTGCT|TTCAGTACGCTATGGGTTCCTGATTTAGGC
GCTTGATCATTCGAGTACGTGCGCATGTAT|CCTGGCTCGCGTATGTTACGTAGGATTGTC
TACGTGCCATTAACTATCCGCGTAGAGTTC|CCCTCCAATATGCCGACTTAGGAAGAATAT
GCCCGCGATTTGATTTAGGCTTGATCATTC|TGATCATTCGAGTACGTGCGCATGTATCCA
TACGTGCACAATAGGTACAAAGACCTACCG|GTACACCGAGGATTTCTAGCTTGTGCTCTG
GAGTACGTGCTTGATCATTCGAGTACTGAT|CACTTTCTGAAGGACACACCTCTGTGGGAA
GTACGTGCACAATAGGTACAAAGACCTACC|GGTACACCGAGGATTTCTAGCTTGTGCTCT
GCAACTGGGGAGTGATTTAGGCTTGATCAT|CGTGCTCGAGATGATTTAGGCTTGATCATT
TCATTCGAGTACGTGCCCGAGGTTGATTTA|ACGTGCAACGTAATTCCTAGTCAGCGTAAC
GTTTTACTGGCCATGATAAAGTTCAGTACG|CTGTACCCTCTCCCCCTTGACCTTCCGTCC
CGAGATCTCAGAGTTATCCTGGCTCGCGTA|GATTTCCGTGGAGAAGGCCTGCCTCTAAAA
CTTGTAGCACTAGCACAATGCGAATCTGAA|CGTGCGTGCAAGAAACGCTTGCTTTCCAAA
ATAGTGTGCGGGGACGTGAGCCCGGAGAGG|ACGTGCCCGAGGTTGATTTAGGCTTGATCA
TACGTGTATCTGAGTCAAGAAACTCCATGT|GTTCCTTCGACCGAAGTTTTACTGGCCATG
TGCGTGCAAGAAACGCTTGCTTTCCAAACC|CGATACTCTGATTTCAACGCTGTTGCGATG
TGATCATTCGAGTACGTGCCATTAACTATC|ATGTATCCAGGTCCCTCCAATATGCCGACT
CTGGGCAACTGGGGAGTGATTTAGGCTTGA|AGTACGTGCTCGAGATGATTTAGGCTTGAT
AAGCTGTACCCTCTCCCCCTTGACCTTCCG|ACGAGCAGCGCACACCCCAACGGTCCCGGT
CTATGTAGGTCTGATTTAGGCTTGATCATT|ATAAGTGATTTAGGCTTGATCATTCGAGTA
TTTAGGCTTTGATTTAGGCTTGATCATTCG|GATGCGCCCTATAAAACCTAACGGGTACAT
CGGGTGCCCAACTCTGATCCCCTTGTAGCA|TTAGGCTTGATCATTCGAGTACGTGCGTGC
GATACTAATACGCGTGGTCTAGCGGGTGCC|GCTTGATCATTCGAGTACTGATTTAGGCTT
AGACCTACCGGCTAAGCTGTACCCTCTCCC|TTGTGCTCTGGATACGAGCAGCGCACACCC
TGACCACTCCTTCGAAGTGGATACTAATAC|CTTGATCATTCGAGTACGTGCTTGATCATT
TGATTTAGGCTTGATCATTCGAGTACGTGC|TTGATCATTCGAGTACGTGCAACGTAATTC
GATCATTCGAGTACGTGCCATATAGATTTC|CTATGGATGCGCTGAGCTATGATTTAGGCT
CCATATAGATTTCCGTGGAGAAGGCCTGCC|TATGATTTAGGCTTGATCATTCGAGTACGT
TTAGGCTGATTTAGGCTTGATCATTCGAGT|TAGCACATGCAAGTGGTATTCTAAGACACT
ATTAATTACATCGAGATCTCAGAGTTATCC|CGTGCCATATAGATTTCCGTGGAGAAGGCC
CAACTGGGGAGTGATTTAGGCTTGATCATT|GTGCTCGAGATGATTTAGGCTTGATCATTC
TTGATCATTCGAGTACTGATTTAGGCTTGA|AGGACACACCTCTGTGGGAAGCCACGAAGA
TTGATCATTCGAGTACGTGCGATCATTCGA|AACGGGTACATTAGCCGAAAACAGCGTACA
GTTAAAGATAAGTGATTTAGGCTTGATCAT|GAATCTGAAAATCTAGGGTTCCCGCCCGTG
GATTTAGGCTTGATCATTCGAGTACGTGCA|GGCTTGATCATTCGAGTACGTGCCTCTATG
TAGGCTTGATCATTCGAGTACGTGCAGTCA|AGGCTTGATCATTCGAGTACGTGCAGCCGA
ATCTAGGCTTTGTTATTTCGTAGTGATTTA|TACATTAATTACATCGAGATCTCAGAGTTA
ACGTGCAACGTAATTCCTAGTCAGCGTAAC|CTCTATGACCACTCCTTCGAAGTGGATACT
ATCATTCGAGTACTGATTTAGGCTTGATCA|ACACACCTCTGTGGGAAGCCACGAAGACAC
TAGAGTTCGCCGATTAATGTCTACTCAAAC|AAGAATATAGTGTGCGGGGACGTGAGCCCG
TGATCATTCGAGTACGTGCCACCGTTAAAG|CCCTTGTAGCACTAGCACAATGCGAATCTG
CAGTTCGCCTTGGCGTGTAGTCCTCTACGT|GAGCCTACGCGGCGAGAACATGCAGGTTCC
CTGAGCTATGATTTAGGCTTGATCATTCGA|CGGGTGCCCAACTCTGATCCCCTTGTAGCA
AGACACTCTCCCCAGACGATACTCTGATTT|ATCTGAGTCAAGAAACTCCATGTAGGGATG
AACCTGGGCAACTGGGGAGTGATTTAGGCT|TCGAGTACGTGCTCGAGATGATTTAGGCTT
TGAAGGACACACCTCTGTGGGAAGCCACGA|GTTCGCCTTGGCGTGTAGTCCTCTACGTGT
TTGATCATTCGAGTACGTGCAGTCAGTTCG|TGATCATTCGAGTACGTGCAGCCGAGCCTA
AAAATCTAGGGTTCCCGCCCGTGATTTAGG|AACCGTCGCAGTCTTCAACGTAGCATAGCA
GATGATTTAGGCTTGATCATTCGAGTACGT|AAGTTCAGTACGCTATGGGTTCCTGATTTA
TTTAGGCTTGATCATTCGAGTACGTGCTTG|CAAGTGGTATTCTAAGACACTTTCTGAAGG
TTCGTAGTGATTTAGGCTTGATCATTCGAG|AGATCTCAGAGTTATCCTGGCTCGCGTATG
AAACGCCGTTAAGGCATCTAGGCTTTGTTA|CCCGGAGAGGGTAGGTACATTAATTACATC
GAAGTGGATACTAATACGCGTGGTCTAGCG|GTACGTGCTTGATCATTCGAGTACTGATTT
ATTTAGGCTGATTTAGGCTTGATCATTCGA|CATAGCACATGCAAGTGGTATTCTAAGACA
TGCCACCGTTAAAGATAAGTGATTTAGGCT|ACAATGCGAATCTGAAAATCTAGGGTTCCC
CCAATATGCCGACTTAGGAAGAATATAGTG|TGATTTAGGCTTGATCATTCGAGTACGTGC
CTGATCCCCTTGTAGCACTAGCACAATGCG|TTCGAGTACGTGCGTGCAAGAAACGCTTGC
GATTGTCTTAGTTTCGATGATTTAGGCTTG|GTAGGTCTGATTTAGGCTTGATCATTCGAG
CACAATGCGAATCTGAAAATCTAGGGTTCC|AACGCTTGCTTTCCAAACCGTCGCAGTCTT
GCTTGATCATTCGAGTACGTGCTCGAGATG|CGCTATGGGTTCCTGATTTAGGCTTTGATT
ACTCTCCCCAGACGATACTCTGATTTCAAC|GAGTCAAGAAACTCCATGTAGGGATGATTT
ACGTAATTCCTAGTCAGCGTAACCAGGCCT|ACCACTCCTTCGAAGTGGATACTAATACGC
GGGTTCCCGCCCGTGATTTAGGCTGATTTA|CAGTCTTCAACGTAGCATAGCACATGCAAG
GCTTTGATTTAGGCTTGATCATTCGAGTAC|GCCCTATAAAACCTAACGGGTACATTAGCC
TTCCTAGTCAGCGTAACCAGGCCTATGGAT|CCTTCGAAGTGGATACTAATACGCGTGGTC
ATGCAGGTTCCTTCGACCGAAGTTTTACTG|TACAAAGACCTACCGGCTAAGCTGTACCCT
CGAGTACGTGCAGCCGAGCCTACGCGGCGA|GTACGTGCGATCATTCGAGTACGTGCACAA
TCTAAGACACTTTCTGAAGGACACACCTCT|AGTACGTGCAGTCAGTTCGCCTTGGCGTGT
ACTGATTTAGGCTTGATCATTCGAGTACGT|TGGGAAGCCACGAAGACACTCTCCCCAGAC
ACGTGTATCTGAGTCAAGAAACTCCATGTA|TTCCTTCGACCGAAGTTTTACTGGCCATGA
TAGGGTTCCCGCCCGTGATTTAGGCTGATT|CGCAGTCTTCAACGTAGCATAGCACATGCA
GATCATTCGAGTACGTGCGCATGTATCCAG|GCTCGCGTATGTTACGTAGGATTGTCTTAG
